MID_AFTER_Lueur_Text	新たなる神竜王として即位。\nルミエルの面影を宿す優しき王となる。\n仲間たちとの絆は子孫へと繋がり、\nエレオス大陸は永き平穏に包まれた。\n\n時折、異形兵の残党を薙ぎ倒す\n蒼い髪の紋章士を見たとの証言が\n様々な年代の記録に残っているが、\nその正体が神竜王自身だったのか\nかの戦友であったのかは不明である。
MID_AFTER_Lueur_Pair	神竜\x0E\x06\x03\x00は、\n新たなる神竜王として即位。\n各国の王や仲間たちと繋いだ強固な絆で\nエレオス大陸を永き平穏へと導いた。
MID_AFTER_Lueur_Vandre	パートナーであるヴァンドレは、\n戦後暫くすると竜の守り人の座を\n後継に譲り渡したが、甲斐甲斐しく、\n時に厳しく神竜王の世話をする姿は\n生涯変わることがなかったという。
MID_AFTER_Lueur_Clan	パートナーであるクランは、\nいつしか心身共に立派な青年となり、\n第三十三代竜の守り人を兼任しながら\n神竜王を献身的に支え続けた。晩年も\nピクルス作りの腕は衰えなかったそう。
MID_AFTER_Lueur_Fram	パートナーであるフランは、\n第三十三代竜の守り人を兼任しながら\n神竜王に愛情と尊敬を注ぎ続けた。\n神竜王が民の前に立つ時には、誰よりも\n声援を送り、場を盛り上げたという。
MID_AFTER_Lueur_Alfred	パートナーであるアルフレッドは、\nフィレネ国王として即位後も鍛錬に励み\nフィレネ、リトス両国のため働いた。\n神竜王の加護のお陰か、とても長生きし\n幸福に満ちた生涯となったという。
MID_AFTER_Lueur_Boucheron	パートナーであるブシュロンは、\n神竜王を傍で支え守りながらも\n祖国の港町の復興に尽力した。\n以前の姿を取り戻した町を目にした時は\n主君や仲間と共に涙したという。
MID_AFTER_Lueur_Etie	パートナーであるエーティエは、\nリトスの地を蘇らせる為、鍛錬を兼ねて\n花の種を蒔いて回ることが多々あった。\n一面の花畑の中、仲睦まじく過ごす\n二人の姿がよく見られていたという。
MID_AFTER_Lueur_Celine	パートナーであるセリーヌは、\n政の面で手腕を発揮し神竜王を支えた。\n時に非情な決断を下すこともあったが、\n二人で過ごすお茶の時間を何よりも\n大切にする優しい心は変わらなかった。
MID_AFTER_Lueur_Louis	パートナーであるルイは、\n神竜王と並び立つに相応しくあろうと\n花園を見る暇もないほど働いた。\n一日の終わりには必ず温かな紅茶を\n神竜王の私室に届け、語らったという。
MID_AFTER_Lueur_Chloe	パートナーであるクロエは、\n公務に追われる神竜王を助け癒した。\n二人の睦まじい姿はいつしか民たちから\n絵になる組み合わせの二人と称され、\n後の世で御伽噺となったという。
MID_AFTER_Lueur_Diamand	パートナーであるディアマンドは\n戦後すぐにブロディア国王として即位。\n侵攻ではなく産業で国を豊かに導いた。\n晩年は国王を退いたディアマンドが\nリトスで穏やかな時を過ごしたという。
MID_AFTER_Lueur_Umber	パートナーであるアンバーは、\n神竜王たっての希望でブロディアより\nアルパカたちを呼び寄せ牧場を作った。\n式典の際にはアルパカ騎兵隊を結成し、\n何代も語り継がれる伝説となったとか。
MID_AFTER_Lueur_Jade	パートナーであるジェーデは、\n王城騎士の育成にあたり、城を護る傍ら\n神竜王との生活をまとめた物語を執筆。\n親しみやすい愉快な文体が民の心を掴み\n千年の後の世まで読み継がれたという。
MID_AFTER_Lueur_Staluke	パートナーであるスタルークは、\n執政で力を発揮しリトスを再興させた。\n見違えるように泰然たる振る舞いとなり\n公私ともに神竜王を支え守ったが、何か\n失敗すると派手な土下座をしたという。
MID_AFTER_Lueur_Lapis	パートナーであるラピスは、\n何でも作る腕を政治の面で開花させ、\n民の気持ちに寄り添える王族として\n神竜王と共に愛された。趣味で栽培した\nリトス芋は聖地の特産品となったそう。
MID_AFTER_Lueur_Citrinica	パートナーであるシトリニカは、\n財力や人脈をリトスや各国の為に捧げ\n戦後の復興を推進した。その献身が\n支持され、神竜王と寄り添う銅像が\n故郷ブロディアに建てられたという。
MID_AFTER_Lueur_Ivy	パートナーであるアイビーは、\n戦後すぐにイルシオン国王として即位。\n神竜王の助けを受け、復興に尽力した。\n仲睦まじい二人の姿は民にも支持され、\n神竜信仰が根付く切欠となったという。
MID_AFTER_Lueur_Zelkova	パートナーであるゼルコバは、\n表舞台に立たず陰から神竜王を支えた。\n後の歴史書には殆ど記載が見られず\n謎の人物とされるが、忙しく働く傍ら\n神竜王と「趣味」を楽しんでいたそう。
MID_AFTER_Lueur_Kagetsu	パートナーであるカゲツは、\nリトスを訪れる民を片っ端から友達にし\n図らずも、聖地の親しみやすさに貢献。\n晩年になっても神竜王と「でーと」をし\n睦まじく過ごす姿が見られたという。
MID_AFTER_Lueur_Hortensia	パートナーであるオルテンシアは、\n一度イルシオンに戻り、アイビーを助け\n復興に励む傍ら学園での勉学に励んだ。\nリトスに来る頃には淑やかな人物となり\n学んだ知識で神竜王を支えたという。
MID_AFTER_Lueur_Rosado	パートナーであるロサードは\n学園を卒業した後、神竜王城へと移る。\n絵画や装飾品で王城を華々しく彩り、\nリトスに於ける芸術の発展に貢献した。\n二人の肖像画は数千年飾られたとか。
MID_AFTER_Lueur_Goldmary	パートナーであるゴルドマリーは\n学園を卒業した後リトスの地へと移り、\n王城の一角で子供たちに物を教えた。\n式典の際には必ず、神竜王とお似合いで\nすみませんと謝るのが名物だったそう。
MID_AFTER_Lueur_Misutira	パートナーであるミスティラは、\n数年の後にソルム女王として即位。\n神竜王とは縛り合わぬ関係でありながら\n逢瀬は多かったため、リトスやソルムで\n仲良く肉を焼く姿が目撃されたという。
MID_AFTER_Lueur_Merin	パートナーであるメリンは、\n故郷の村長の座を兄の一人に譲り渡し、\nリトスの地で動物の研究に励んだ。\n生涯をかけ神竜王と作り上げた図鑑は、\n後の世の民に大きく評価されたという。
MID_AFTER_Lueur_Panetone	パートナーであるパネトネは、\n慣れぬ公務に勤しみながら両親のことを\n探したが消息を掴む事は叶わなかった。\n神竜王とは年を取っても大層仲睦まじく\n結局、一度も喧嘩はしなかったという。
MID_AFTER_Lueur_Fogato	パートナーであるフォガートは、\n外交と執政を担い、神竜王を助けた。\n時折ふらりと出かけては土産を持ち帰り\n愛の言葉と共に神竜王に贈ったそう。\n二人は晩年も新婚のようだと称された。
MID_AFTER_Lueur_Pandoro	パートナーであるパンドロは、\nリトスに大教会を設立し、年に一度は\n誰でも参加できる大きな宴を開いた。\n宴には神竜王自身も必ず参加し、時折\n軽快で珍妙な挨拶をかけていたという。
MID_AFTER_Lueur_Bonet	パートナーであるボネは、\nリトスの食材で新たな料理を次々創作し\n神竜王の健康を守り続けた。\n後の世で、リトスは聖地でありながら\n美食の地であるとの評価をされている。
MID_AFTER_Lueur_Anna	パートナーであるアンナは、\n戦後暫くして家族との再会を果たす。\n神竜王と共にリトスの名産品を用いた\n新商品を開発し続け、大人になった頃に\n国を揺るがす売上を叩き出したという。
MID_AFTER_Lueur_Jean	パートナーであるジャンは、\n成人後立派な医者として、王城の一角で\n民たちの診察をし、多くの命を救った。\n自身の健康管理の賜物か、神竜王の為か\n戦後百年以上も生きたと言われている。
MID_AFTER_Lueur_Yunaka	パートナーであるユナカは、\n周囲が驚くほど落ち着いた人物となり\n鋭い観察眼と、時には汚れ仕事をこなす\n豪胆さで神竜王を陰日向から支えた。\n晩年も物真似の腕は衰えなかったそう。
MID_AFTER_Lueur_Seadas	パートナーであるセアダスは、\n占いや踊りで民を魅了し、神竜王と共に\n絶大な人気を得た。後の世の文献では\n神秘的と称されたが、いつも城で元気に\n食事をしていた姿は神竜王のみが知る。
MID_AFTER_Lueur_Linden	パートナーであるリンデンは、\n老練の叡智でリトスを再興へ導いた。\n数年後に天国の妻の元へと旅立ったが、\n共に過ごした思い出は神竜王の心に\n雷の如く鮮烈に残り続けたという。
MID_AFTER_Lueur_Saphir	パートナーであるザフィーアは、\nじっとしているのは性に合わないと\n王城騎士として城と神竜王を守った。\n晩年まで腕を高めることに余念がなく、\n神竜王との鍛錬は欠かさなかったそう。
MID_AFTER_Lueur_Veyre	パートナーであるヴェイルは、\nグラドロンの地を豊かな国へと導き\n恵まれない子たちの孤児院を設立した。\nそこで育った優しき竜族の子が数千年後\n二人の後継として大陸を統べたという。
MID_AFTER_Lueur_Mauve	パートナーであるモーヴは、\n身分を隠し人助けを続け、民の間では\n出会えば救われる美丈夫の噂が立った。\n公務ではあまり表舞台に立つことはなく\n静かに優しく神竜王を支えたという。
MID_AFTER_Vandre_Text	神竜\x0E\x06\x03\x00の即位後、\n守り人の座を後継へと譲り渡す。\n以降は一介の騎士として\n浮遊島ソラネルの管理を引き受け、\n生涯を神竜のために捧げた。\n\n神竜王や仲間たちはヴァンドレに会いに\n頻繁にソラネルを訪れたため、\n旅の途中のような賑やかな光景に\nいつも目を細めていたという。
MID_AFTER_Clan_Text	先代の守り人から任を継ぎ、\n正式に第三十三代竜の守り人となる。\n心身ともに立派な青年となり、\n冷静沈着な仕事ぶりはまるで\n往年のヴァンドレのようだったという。\n\n神竜王への大きな尊敬は変わらず、\n後継の守り人を選ぶ際は\nどれだけ神竜王への愛が深いかを重視し\n自ら試験問題を作ったほどであった。
MID_AFTER_Fram_Text	先代の守り人から任を継ぎ、\n正式に第三十三代竜の守り人となる。\nおっちょこちょいな面は鳴りを潜め、\nかつてのヴァンドレを思わせる程の\n気配りができる人物となった。\n\n神竜王への大きな愛情は変わらず、\n後継の守り人を選ぶ際は\n神竜王への声援の大きさを重視し\n守り人候補の大声大会を主催したそう。
MID_AFTER_Alfred_Text	数年の後、フィレネ国王として即位。\nリトスや各国との親交をさらに深め\n平和な国としての地盤を強固にした。\n彼の結んだ新たな不戦同盟は永きに渡り\nフィレネ王国を戦から守り続けた。\n　\n国王としての在位は長くなく、\n後の文献では短命だったとある。\nしかし花のように咲き誇り民に愛された\n彼の生涯は、間違いなく幸福であった。
MID_AFTER_Boucheron_Text	主君と共に、フィレネ復興に尽力する。\n大きな爪痕の残るフルルの港町は\n立ち直るまでに長い年月を要したが、\n以前の姿を取り戻した時には\nかつてないほどの嬉し涙を流した。\n\n王城から港町へ行く道だけは\n迷うことがないほど通い詰めており、\nその優しさと献身を称え、街道には\nいつしか彼の名がつけられたという。
MID_AFTER_Etie_Text	自慢の腕っ節を活かし\n主君とフィレネのために働いた。\n王城兵の育成には多大な貢献をし、\n彼女の編み出した効率的な鍛錬と\n味の良い筋肉増強剤のおかげで、\nフィレネ城には平和の国に似合わぬ程の\n屈強な騎士が増えたそう。\n\n故郷では彼女の活躍を讃え、今でも\n橙色の花が一面に植えられている。
MID_AFTER_Celine_Text	即位した兄王を支え、\nフィレネ王国の為にその生涯を捧げた。\n治安を乱す者には厳しい制裁を加え、\n時に嫌われ役になってでも\n平和を守った姿は、真の王族として\n後の歴史書でも称えられている。\n\n彼女の好んだ茶葉はフィレネ全土で\n幸福のお茶とされ、飲むと小さな幸せが\n見つかるという伝承が生まれた。
MID_AFTER_Louis_Text	武器を取る任からは退き、\n王族の執事として貴人に仕えた。\n彼の淹れる芳醇な紅茶は\n戦後の任に疲労した体を癒し、\n細やかな気配りは執政を滞りなく\n機能させる助けとなったという。\n\n献身的な姿に惚れ込み求婚する者も\n多く現れたそうだが、それには顧みず、\n遠くから花園を見ることを選んだ。
MID_AFTER_Chloe_Text	王城兵の任に一層励み、\n公務に励む王族や鍛錬疲れの兵に\n珍味を差し入れては元気づけた。\n最初は怪訝な顔をしていた者も虜になり\n以後、フィレネの名物料理には\n少し変わった味のものが増えたとか。\n\n数年後、屋台で出会った人物と\n御伽噺のような大恋愛をし、\n生涯の伴侶を得ることとなる。
MID_AFTER_Diamand_Text	終戦後、ブロディア王として即位。\nモリオン王の勇敢な遺志は継ぎつつも、\n他国への侵攻は決して行わなかった。\n特にイルシオンに対する民の感情を\n正すことに長い年月をかけたという。\n\nその方針は貴族たちの反感を買い\n武力の国の名折れだと言う者もいたが、\n鉱石の輸出で国を豊かにした政策は\n後の世で偉勲とされている。
MID_AFTER_Umber_Text	主君の即位を大いに喜び、\n戦後の混乱を収めるために奔走した。\n行く先では数々の珍騒動が起き、\n愉快な伝承へと姿を変えることとなる。\n\n歴史書にはディアマンド王の\n信頼を受けた騎士として記述され、\n彼自身もまた、憧れた伝説となった。\nその肖像画は必ずアルパカに跨った姿で\n描かれており、識者を悩ませたという。
MID_AFTER_Jade_Text	主君の即位を笑顔で祝福し、\n王の騎士として国のため尽くした。\n忙しく任務を果たしながらも\n物語の執筆をやめることはなく、\nその巻数は百をゆうに超えたという。\n\n彼女が生涯をかけて書いた戯話は\n後世の人々の腹筋を震わせ、\n神竜王にいつまでも懐かしく\n昔を思い起こさせる名著となった。
MID_AFTER_Staluke_Text	王城での書類仕事を担いながら、\n時折イルシオンに渡り復興を支援した。\n民のブロディアへの感情が緩和したのは\n彼の功績であるとも言われ、結果的に\n両国の推し進める貿易の後押しをした。\n\n歴史書では、その謙虚すぎる姿勢も含め\n大変な策士だと評価されている。\n彼がかつてモリオン王に告げた\n兄を守るとの言葉は生涯違えなかった。
MID_AFTER_Lapis_Text	戦災で荒れた土地に出向き、\n家や物の修理方法や自給自足の術を\n懇切丁寧に教えて回った。\n彼女の訪れた地には必ず、やたら美味で\n大きな芋が置き土産にされたという。\n\n後年その芋が評判となり、名産地である\n芋の村は莫大な富を得て豊かになった。\n図らずも宣伝をしたラピスは村の皆から\n芋の女神と言われ崇められたそう。
MID_AFTER_Citrinica_Text	戦争を推し進める貴族たちに対し\n新たな利を生む話を持ち掛け、\n和平の道を説き続けた。\n全ての者の説得は叶わなかったが\nいくつかの家は彼女の話に感銘を受け、\n王の強固な後ろ盾となったという。\n\n気苦労は多かったが暗さは見せず、\n大好きな舞踏会で踊る笑顔はいつも\n気品溢れる煌びやかなものであった。
MID_AFTER_Ivy_Text	終戦後、イルシオン王として即位。\n蹂躙された各地の復興に尽力しながら\n閉鎖的であった国の体質を変え、\nイルシオンの叡智はそのままに\nブロディアとの共存を推し進めた。\n\n輸入した鉱石の加工産業を興し\n活気ある国へ導いた点は特に評価され、\nアイビーの名は敬愛する神竜王の\nその寿命よりも長く、歴史書に残った。
MID_AFTER_Zelkova_Text	アイビー王の片腕として任を果たす。\nイルシオンの戦災孤児に心を痛め、\n孤児院の設立を促すとともに\n自ら何人もの子を引き取って育てた。\n家族ができると、より一層仕事に励み\n趣味の時間もないほどの多忙を極めたが\n彼自身は幸せそうであったという。\n\n子供たちは父ゼルコバの真似をして、\n妙に「意味深」な話し方をしたとか。
MID_AFTER_Kagetsu_Text	王の即位後、忽然と姿を消す。\n新たな強者を探しに旅立ったのではと\n憶測を呼ぶが、真相は謎のままである…\n\nという空気になった頃、王城に帰還。\n故郷の家族と話をし、家督は継がず\n他国で生きる許しを得たと申し開き、\n以降はアイビー王のために働いた。\nたまに里帰りをした際は沢山の米を\nお土産にと持ち帰ったという。
MID_AFTER_Hortensia_Text	姉の即位を見届け、学園に戻る。\n戦後の混乱の中ではあったものの\n優秀な成績を修め、首席で卒業。\n学んだ知識と天性の愛嬌で\n口下手なところのある姉をよく助け、\nブロディアとの外交も盛んに行なった。\n\nイルシオンの再起はアイビー王と\n妹オルテンシアの献身の賜物だとされ、\n二人は晴雪の姉妹と語り継がれたそう。
MID_AFTER_Rosado_Text	騎士として叙勲を受けた後、\n各地に残る異形兵討伐の任に就く。\n戦を嫌った彼だったが、学友たちが\n勉学に励めるようにとの選択だった。\n後に自身も学園に戻り、卒業を果たす。\n\n晩年は芸術家として大成し、\n可憐な王城兵との二つの顔を持った。\nイルシオン城に永劫残る王族の肖像画は\n彼の手がけた作品と言われている。
MID_AFTER_Goldmary_Text	騎士として叙勲を受けた後、\n学園に戻り勉学に励んだ。\n人に物を教える意外な才を見出され\n騎士の任に励む傍ら、教師の道を志し\n自称・学園屈指の美人教師となる。\n\n彼女の教え子には次代のイルシオンを\n担う要人となる者も多く出たが、\n授業は毎回、その知性と美貌を\n深く謝罪する挨拶から始まったとか。
MID_AFTER_Misutira_Text	戦後のいざこざを解決する名目で、\nソルムのみならず各国を放浪した。\n王女としての責務は忘れず、城に戻ると\n明るい笑顔で客人をもてなしたという。\n\n長年、自由を謳歌したため\n王として即位したのは随分後となるが、\n放浪時代に触れ合った民たちから\n友人のように愛され、ソルム有史以来\n絶大な支持を得る女王となった。
MID_AFTER_Merin_Text	ミスティラの騎士として同行する傍ら、\n旅の中で出会った動物の生態をまとめ\n世界の珍獣図鑑を完成させる。\n個性的な著書のため\n手に取る人はあまり多くなかったが、\n神竜王やヴェイルの貴重な情報もあり\n後世では非常に高く評価された。\n\n晩年、騎士を退いた後は故郷に戻り\n村長として村をまとめ上げたという。
MID_AFTER_Panetone_Text	ミスティラの騎士として仕え、\n時には城で影武者を務めた。\n留守番中、城内で肉を焼くなど\n主君に似た奔放な行動をする反面、\n腕っぷしには日々磨きをかけ\n怪しい者は拳一発で沈めたという。\n\n行方不明の両親の消息は掴めず\n再び言葉を交わすことは叶わなかったが\nこっそりと、実家の教会を再建した。
MID_AFTER_Fogato_Text	姉が即位するまで、ふらりと旅に出る。\n見聞を広げ戻ってきた後は\nミスティラ女王の補佐として働いた。\n陰で動くことの多い役割を担ったとされ\n明るく目立つ人柄に反し、\n歴史書には確かな記述が少ない。\n\n人一倍愛情深かったのは確かなようで、\n旅先で出会った人物と情熱的な恋をし、\n生涯添い遂げたと言われている。
MID_AFTER_Pandoro_Text	戦後、多くの人を教会へと招き入れ\n竜の種族を問わない新たな信仰を確立。\nリトスの王城にて世界規模の宴を計画し\n神竜王やヴェイルも大いに賛成したが\n既の所でヴァンドレに止められ、\n予定よりも幾分厳かな形で開催された。\n　\n彼が好んで使っていた元気な挨拶は、\n後に神竜王を崇める際の特別な祝詞に\nなったとか、ならなかったとか。
MID_AFTER_Bonet_Text	念願であった実家の食堂を再建。\nソルム王家、そして神竜王も食した\n美食の店として大繁盛を極めたが、\n暫くすると後継に店を譲り渡し\n各国の味見をして回った。\n\n旅で得た調理法は書物に纏められ、\n料理人の聖典として伝わることとなる。\n彼の死後も、かつて腕を振るった味は\n民たちや神竜王の舌を楽しませた。
MID_AFTER_Anna_Text	家族と再会を果たし、成人後は\n立派な行商人として大陸を回った。\n同じ顔と名の姉妹は大勢いたが、\n神竜王と共にいたアンナだけは、\nかつての旅を懐かしむように指輪を作り\n各地で売り歩いたという。\n\n先の戦争での紋章士の活躍が後押しし\n指輪は民たちに大流行。\n念願の大儲けを果たすこととなる。
MID_AFTER_Jean_Text	故郷に戻って勉強を続け、\n若くして立派な医者となる。\n診療所を継いだ後も、月に一度は\n往診のためにリトスに訪れ、\n神竜王に元気な姿を見せた。\n\n新しい薬の調合に熱心で、\n故郷の名産の茶葉は彼の研究の結果\n万病に効く薬となったことが\n後の世の医術書に記載されている。
MID_AFTER_Yunaka_Text	戦いの後、大道芸を始める。\nその演技力で見る者を魅了したが、\nある時、ぱたりと行方知れずとなる。\n　\nどこかで命を落としたとも、\n別人として生きたともされているが\n確かな情報がなく推測の域を出ない。\n　\n神竜王がたまに発する珍妙な言葉は\n彼女の影響だといわれている。
MID_AFTER_Seadas_Text	流浪の旅人として、ソルム以外でも\n占いや踊りを披露し生計を立てた。\n各国に熱狂的なファンを作り、\n晩年は神竜王との旅を言い伝える\n吟遊詩人の役割も果たしたとか。\n\n旅立つ前に行った占いでは\n各国の美味を楽しみ、出会いに恵まれ、\n幸せな生涯を送るという結果が出たが\n見事的中したことは疑いようがない。
MID_AFTER_Linden_Text	あとは若者に任せると言い残し\n懐かしい我が家へと戻る。\n好きな読書や実験を楽しみ\n気ままな隠居生活を送っていたが、\nある春の朝、最愛の妻の元に旅立つ。\n\n神竜王や仲間たちは春雷が轟くたび、\n彼の愉快な実験の数々や\n独特な焼き菓子に思いを馳せた。
MID_AFTER_Saphir_Text	ブロディア王城に戻り、\nディアマンド王の護衛の任に就く。\n腕の衰えを感じると潔く引退し、\n故郷で魚料理の店を開いた。\n小さな店構えに反し、各国の王城兵や\n時には王族まで客として訪れたため\n名店として繁盛したという。\n\n看板メニューは、かつてモリオン王が\n最も好んだ魚料理だった。
MID_AFTER_Veyre_Text	浮上したままであったグラドロンの地を\n預かり、緑溢れる国土へと導いた。\n王族としての身分は望まないと\nただの竜族であり続けようとしたが、\n民たちの願いもあり、終戦より百余年後\nグラドロン王国の初代国王となる。\n　\nその姿をかつての仲間たちが見ることは\n叶わなかったが、その子孫たちや、\nきょうだいである神竜王が祝福した。
MID_AFTER_Mauve_Text	ヴェイルの元に身を寄せ、罪滅ぼしにと\n人助けや各国の復興に尽力した。\nその善行は彼が晩年に至るまで続いたが\nある日出かけたきり、その消息を絶つ。\n不慮の事故に遭ったのだとも、\n四狗に恨みを持つ人間に謀られたとも\n言われているが、真実は定かではない。\n\n確かなのは、彼が最期までヴェイルと\n神竜王を気にかけていたことである。
MID_AFTER_Lost_Text	\x0E\x01\x00\x00にて倒れる
