MID_RELIANCE_C_#001	キャラ配置(PID_アルフレッド, ME_IN_C, [服装], Normal, IdleNormal, -5)\nキャラ配置(PID_アイビー, YOU_IN_BC, [服装], Normal, IdleNormal, -95)\nキャラ表示切替(PID_アルフレッド, False)\n\nキャラ配置(PID_デモ用_視線設定用, ME_OUT_C, [服装], Die, IdleNormal, 0)\nキャラ配置調整(PID_デモ用_視線設定用, 0, -1, 0)\n\n背景(Map_Event_Hub_Solanel_09_Night)\nライト(CharaLight_Hub_Night, 0, 0, 0)\n\nキャラ視線(PID_アルフレッド, PID_アイビー, PID_アイビー)\n\nウェイト(0.3)\n\nシーンカメラ(SceneCam_SideMe_Right_Mid, cam_anim_track_l_slow)\nフェードイン()\n*\nキャラ表示切替(PID_アルフレッド, True)
MID_RELIANCE_C_#002	キャラモーション再生(PID_アルフレッド, Normal, WalkIn2)\nキャラカメラ(CharaCam_Shoulder_Left_Mid, PID_アイビー, cam_anim_pan_l_normal)\nキャラモーション再生(PID_アルフレッド, Normal, EmoTalk, 1, 1)\n\nキャラ視線(PID_アイビー, PID_アルフレッド, PID_アルフレッド)\n*\nキャラモーション再生(PID_アルフレッド, Normal, IdleNormal)
MID_RELIANCE_C_#003	キャラカメラ(CharaCam_Side_Right2_Mid, PID_アイビー, cam_anim_track_l_slow)
MID_RELIANCE_C_#004	キャラモーション再生(PID_アイビー, Relax, EmoThink,,1)
MID_RELIANCE_C_#005	キャラカメラ(CharaCam_FrontLong2_Right_Mid, PID_アイビー, cam_anim_dolly_r_normal)
MID_RELIANCE_C_#006	キャラモーション再生(PID_アイビー, Die, EmoDeny,,1)\nキャラモーション再生(PID_アイビー, Die, IdleNormal, 3.5, 1)\n*\nキャラモーション再生(PID_アイビー, Normal, IdleNormal)
MID_RELIANCE_C_#007	キャラカメラ(CharaCam_Side_Left2_Mid, PID_アルフレッド, cam_anim_pan_l_slow)\nキャラモーション再生(PID_アルフレッド, Normal, EmoDeny2,,1)\n*\nキャラモーション再生(PID_アルフレッド, Relax, IdleNormal)
MID_RELIANCE_C_#008	キャラカメラ(CharaCam_Side_Right_Mid, PID_アイビー, cam_anim_dolly_r_normal)\nキャラモーション再生(PID_アイビー, Normal, EmoNod,,1)\n*\nキャラモーション再生(PID_アイビー, Normal, IdleNormal)
MID_RELIANCE_C_#009	キャラカメラ(CharaCam_SideLong_Left2_Mid, PID_アルフレッド, cam_anim_pan_u_slow)\nキャラモーション再生(PID_アルフレッド, Relax, EmoJoy,,1)\n*\nキャラモーション再生(PID_アルフレッド, Normal, IdleNormal)
MID_RELIANCE_C_#010	キャラカメラ(CharaCam_Shoulder_Left_Top, PID_アルフレッド, cam_anim_track2_l_normal)\nキャラ回転(PID_アイビー, 90, 1.3)\nキャラモーション再生(PID_アイビー, Normal, TurnR,, 0.3)
MID_RELIANCE_C_#011	*\nキャラモーション再生(PID_アイビー, Angry, IdleNormal)
MID_RELIANCE_C_#012	キャラカメラ(CharaCam_Front_Center_Mid, PID_アルフレッド, cam_anim_track_r_slow)\nキャラモーション再生(PID_アルフレッド, Normal, EmoDeny2,,1)\n*\nキャラモーション再生(PID_アルフレッド, Normal, IdleNormal)
MID_RELIANCE_C_#013	キャラカメラ(CharaCam_Side_Left2_Mid, PID_アイビー, cam_anim_track_l_normal)\nキャラ視線(PID_アイビー, PID_アルフレッド, PID_デモ用_視線設定用)\n*\nキャラモーション再生(PID_アイビー, Surprise)
MID_RELIANCE_C_#014	キャラカメラ(CharaCam_FrontLong2_Right_Mid, PID_アルフレッド, cam_anim_dolly_r_normal)\nキャラモーション再生(PID_アルフレッド, Normal, EmoTalk2,,1)\n*\nキャラモーション再生(PID_アルフレッド, Normal, IdleNormal)
MID_RELIANCE_C_#015	キャラカメラ(CharaCam_Side_Left_Mid, PID_アイビー, cam_anim_dolly_l_normal)\n*\nキャラ表示切替(PID_アイビー, False)
MID_RELIANCE_C_#016	キャラカメラ(CharaCam_SideLong_Right2_Mid, PID_アルフレッド, cam_anim_track_l_slow)\n*\nキャラ表示切替(PID_アイビー, True)\nキャラ視線(PID_アイビー, PID_デモ用_視線設定用, PID_デモ用_視線設定用)
MID_RELIANCE_C_#017	キャラカメラ(CharaCam_Front_Center_Top, PID_アイビー, cam_anim_pan_u_slow)\nキャラモーション再生(PID_アイビー, Die)
MID_RELIANCE_C_#018	キャラモーション再生(PID_アイビー, Sad)
MID_RELIANCE_C_#019	キャラカメラ(CharaCam_FrontLong2_Left_Top, PID_アルフレッド, cam_anim_track_l_normal)\nキャラモーション再生(PID_アルフレッド, Relax, EmoRelax, 1,1)\n*\nキャラモーション再生(PID_アルフレッド, Normal, IdleNormal)
MID_RELIANCE_C_#020	キャラカメラ(CharaCam_Side_Right2_Mid, PID_アイビー, cam_anim_zoom_in_slow)
MID_RELIANCE_C_#021	キャラモーション再生(PID_アイビー, Sad)\nキャラ視線(PID_アイビー, PID_アルフレッド, PID_デモ用_視線設定用)\n*\nフェードアウト()
MID_RELIANCE_B_#001	キャラ配置(PID_アルフレッド, YOU_IN_D, [服装], Normal, IdleNormal, 15)\nキャラ配置(PID_アイビー, ME_IN_C, [服装], Normal, IdleNormal, -100)\n\nキャラ配置(PID_デモ用_視線設定用, YOU_IN_A, [服装], Normal, IdleNormal, 0)\nキャラ配置調整(PID_デモ用_視線設定用, 0, -0.2, 0)\nキャラ表示切替(PID_アルフレッド, False)\n\n背景(Map_Event_Hub_Solanel_01_Night)\nライト(CharaLight_M001, 0, 0, 0)\n\nキャラ視線(PID_アルフレッド, PID_アイビー, PID_アイビー)\n\nシーンカメラ(SceneCam_SideYou_Right_Mid, cam_anim_pan_l_slow)\nフェードイン()\n\n*\n\nキャラ表示切替(PID_アルフレッド, True)
MID_RELIANCE_B_#002	キャラモーション再生(PID_アルフレッド, Normal, WalkIn2)\nシーンカメラ(SceneCam_Side_Left_Mid, cam_anim_pan_l_slow)\nキャラモーション再生(PID_アルフレッド, Normal, IdleNormal, 1.5, 1)\n\nキャラ視線(PID_アイビー, PID_アルフレッド, PID_アルフレッド)
MID_RELIANCE_B_#003	キャラカメラ(CharaCam_Shoulder_Right_Mid, PID_アイビー, cam_anim_track_l_slow)\nキャラ回転(PID_アイビー, 115, 1.2)\nキャラモーション再生(PID_アイビー, Normal, TurnR,, 0.3)\nキャラモーション再生(PID_アイビー, Normal, EmoTalk2, 1, 1)\n*\nキャラモーション再生(PID_アイビー, Normal, IdleNormal,, 1)
MID_RELIANCE_B_#004	キャラモーション再生(PID_アルフレッド, Normal, EmoJoy,,1)\n*\nキャラモーション再生(PID_アルフレッド, Normal, IdleNormal,,1)
MID_RELIANCE_B_#005	シーンカメラ(SceneCam_SideYou_Right_Mid, cam_anim_track2_l_normal)\nキャラモーション再生(PID_アイビー, Smile, EmoThink,,1)\n*\nキャラモーション再生(PID_アイビー, Smile, IdleNormal,,1)
MID_RELIANCE_B_#006	キャラモーション再生(PID_アルフレッド, Normal, EmoTalk,,1)\n*\nキャラモーション再生(PID_アルフレッド, Normal, IdleNormal)
MID_RELIANCE_B_#007	キャラカメラ(CharaCam_Side_Left_Mid, PID_アイビー, cam_anim_dolly_l_normal)\nキャラ視線リセット(PID_アイビー)\nキャラモーション再生(PID_アイビー, Normal, EmoSad2,,1)\n*\nキャラモーション再生(PID_アイビー, Normal, IdleNormal)
MID_RELIANCE_B_#008	キャラカメラ(CharaCam_Side_Right2_Mid, PID_アルフレッド, cam_anim_pan_r_slow)
MID_RELIANCE_B_#009	キャラカメラ(CharaCam_SideLong_Right2_Mid, PID_アイビー, cam_anim_pan_u_slow)\nキャラモーション再生(PID_アイビー, Die, EmoDeny,,1)\nキャラモーション再生(PID_アイビー, Normal, IdleNormal, 4, 1)\n*\nキャラモーション再生(PID_アイビー, Sad, IdleNormal)
MID_RELIANCE_B_#010	キャラカメラ(CharaCam_Side_Left_Mid, PID_アルフレッド, cam_anim_dolly_l_normal)\nキャラモーション再生(PID_アルフレッド, Normal, EmoThinkIn,,1)\nキャラ視線(PID_アルフレッド, PID_デモ用_視線設定用, PID_デモ用_視線設定用)
MID_RELIANCE_B_#011	
MID_RELIANCE_B_#012	キャラカメラ(CharaCam_Shoulder_Right_Mid, PID_アルフレッド, cam_anim_track_l_slow)\nキャラ視線(PID_アルフレッド, PID_アイビー, PID_アイビー)
MID_RELIANCE_B_#013	*\nキャラ表示切替(PID_アイビー, False)
MID_RELIANCE_B_#014	キャラカメラ(CharaCam_SideLong_Left2_Mid, PID_アルフレッド, cam_anim_zoom_in_slow)\nキャラモーション再生(PID_アルフレッド, Relax, EmoTalk,,1)\n*\nキャラモーション再生(PID_アルフレッド, Relax, IdleNormal)\nキャラ表示切替(PID_アイビー, True)
MID_RELIANCE_B_#015	キャラカメラ(CharaCam_Side_Left2_Mid, PID_アイビー, cam_anim_zoom_in_normal)\nキャラモーション再生(PID_アイビー, Die, EmoShy,,1)\nキャラモーション再生(PID_アイビー, Sad, IdleNormal, 4, 1)\n*\nキャラモーション再生(PID_アイビー, Normal, IdleNormal,,1)
MID_RELIANCE_B_#016	キャラカメラ(CharaCam_Shoulder_Right_Mid, PID_アルフレッド, cam_anim_track_l_slow)\nキャラモーション再生(PID_アルフレッド, Relax, EmoNod,,1)\nキャラモーション再生(PID_アルフレッド, Relax, IdleNormal, 1.5,1)
MID_RELIANCE_B_#017	キャラモーション再生(PID_アルフレッド, Relax, EmoPray,,1)\n*\nキャラモーション再生(PID_アルフレッド, Relax, IdleNormal)
MID_RELIANCE_B_#018	キャラカメラ(CharaCam_Front_Center_Mid, PID_アイビー, cam_anim_track_r_slow)\nキャラモーション再生(PID_アイビー, Normal, EmoAngry,,1)\n*\nキャラモーション再生(PID_アイビー, Normal, IdleNormal)
MID_RELIANCE_B_#019	キャラカメラ(CharaCam_SideLong_Right2_Mid, PID_アルフレッド, cam_anim_zoom_in_slow)
MID_RELIANCE_B_#020	キャラモーション再生(PID_アルフレッド, Relax, EmoJoy,,1)
MID_RELIANCE_B_#021	シーンカメラ(SceneCam_SideYou_Right_Mid, cam_anim_pan_l_normal)
MID_RELIANCE_B_#022	キャラモーション再生(PID_アイビー, Normal, EmoRelax,,1)\n*\nキャラモーション再生(PID_アイビー, Smile, IdleNormal)
MID_RELIANCE_B_#023	キャラカメラ(CharaCam_Front_Center_Mid, PID_アルフレッド, cam_anim_track_l_slow)\nキャラモーション再生(PID_アルフレッド, Smile, EmoNod,,1)\nキャラモーション再生(PID_アルフレッド, Smile, IdleNormal, 1.5,1)
MID_RELIANCE_B_#024	キャラカメラ(CharaCam_Side_Right2_Mid, PID_アイビー, cam_anim_track_l_slow)\n*\nフェードアウト()
MID_RELIANCE_A_#001	キャラ配置(PID_アルフレッド, ME_IN_C, [服装], Normal, IdleNormal, 0)\nキャラ配置(PID_アイビー, YOU_IN_C, [服装], Normal, IdleNormal, 0)\n\n背景(Map_Event_Hub_Solanel_04_Night)\nライト(CharaLight_Hub_Night, 0, 0, 0)\n\nキャラ視線(PID_アルフレッド, PID_アイビー, PID_アイビー)\nキャラ視線(PID_アイビー, PID_アルフレッド, PID_アルフレッド)\n\nウェイト(0.4)\n\nキャラカメラ(CharaCam_FrontLong2_Right_Mid, PID_アイビー, cam_anim_pan_r_normal)\nフェードイン()\n\nキャラモーション再生(PID_アイビー, Normal, EmoTalk2,,1)\n*\nキャラモーション再生(PID_アイビー, Normal, IdleNormal,,1)
MID_RELIANCE_A_#002	キャラカメラ(CharaCam_FrontLong2_Left_Mid, PID_アルフレッド, cam_anim_pan_l_normal)\nキャラモーション再生(PID_アルフレッド, Normal, EmoTalk,,1)\n*\nキャラモーション再生(PID_アルフレッド, Smile, IdleNormal,,1)
MID_RELIANCE_A_#003	キャラカメラ(CharaCam_Side_Right2_Mid, PID_アイビー, cam_anim_track_r_slow)
MID_RELIANCE_A_#004	キャラモーション再生(PID_アイビー, Normal, EmoRelax,,1)
MID_RELIANCE_A_#005	キャラカメラ(CharaCam_Shoulder_Right_Mid, PID_アルフレッド, cam_anim_track_r_slow)\nキャラモーション再生(PID_アイビー, Sad)\n*\nキャラモーション再生(PID_アイビー, Normal, IdleNormal)
MID_RELIANCE_A_#006	キャラカメラ(CharaCam_SideLong_Left2_Mid, PID_アルフレッド, cam_anim_pan_u_slow)\nキャラモーション再生(PID_アルフレッド, Smile, EmoJoy,,1)\n*\nキャラモーション再生(PID_アルフレッド, Relax, IdleNormal)
MID_RELIANCE_A_#007	キャラカメラ(CharaCam_Front_Center_Mid, PID_アイビー, cam_anim_track_r_slow)\nキャラモーション再生(PID_アイビー, Normal, EmoSad2,,1)
MID_RELIANCE_A_#008	
MID_RELIANCE_A_#009	キャラカメラ(CharaCam_FrontLong2_Right_Mid, PID_アイビー, cam_anim_pan_r_normal)\nキャラモーション再生(PID_アイビー, Sad, EmoTired,,1)\n*\nキャラモーション再生(PID_アイビー, Normal, IdleNormal,,1)
MID_RELIANCE_A_#010	キャラカメラ(CharaCam_Shoulder_Left_Mid, PID_アイビー, cam_anim_dolly_l_normal)\nキャラモーション再生(PID_アルフレッド, Relax, EmoTalk2,,1)\n*\nキャラモーション再生(PID_アルフレッド, Normal, IdleNormal)
MID_RELIANCE_A_#011	キャラカメラ(CharaCam_Side_Right2_Mid, PID_アイビー, cam_anim_track_l_slow)\nキャラモーション再生(PID_アイビー, Normal, EmoRelax,,1)\n*\nキャラモーション再生(PID_アイビー, Sad, IdleNormal)
MID_RELIANCE_A_#012	キャラカメラ(CharaCam_Front_Center_Mid, PID_アルフレッド, cam_anim_track_l_slow)\nキャラモーション再生(PID_アルフレッド, Normal, EmoDeny,,1)\n*\nキャラモーション再生(PID_アルフレッド, Smile, IdleNormal,,1)
MID_RELIANCE_A_#013	キャラカメラ(CharaCam_FrontLong2_Right_Mid, PID_アイビー, cam_anim_track2_r_normal)\nキャラモーション再生(PID_アイビー, Sad, EmoDeny2,,1)
MID_RELIANCE_A_#014	キャラモーション再生(PID_アイビー, Sad, EmoTired,,1)\n*\nキャラモーション再生(PID_アイビー, Surprise, IdleNormal)
MID_RELIANCE_A_#015	キャラカメラ(CharaCam_Side_Left2_Mid, PID_アルフレッド, cam_anim_track_r_slow)\nキャラモーション再生(PID_アルフレッド, Smile, EmoSad,,1)
MID_RELIANCE_A_#016	
MID_RELIANCE_A_#017	キャラカメラ(CharaCam_Front_Center_Mid, PID_アルフレッド, cam_anim_zoom_out_normal)\nキャラモーション再生(PID_アルフレッド, Smile, EmoJoy,,1)\n*\nキャラモーション再生(PID_アルフレッド, Relax, IdleNormal)
MID_RELIANCE_A_#018	キャラカメラ(CharaCam_Side_Right_Mid, PID_アイビー, cam_anim_dolly_r_normal)\n*\nキャラモーション再生(PID_アイビー, Normal, IdleNormal,,1)
MID_RELIANCE_A_#019	キャラカメラ(CharaCam_FrontLong2_Left_Mid, PID_アルフレッド, cam_anim_track_r_normal)\nキャラモーション再生(PID_アルフレッド, Relax, EmoTalk,,1)\n*\nキャラモーション再生(PID_アルフレッド, Relax, IdleNormal,,1)
MID_RELIANCE_A_#020	キャラカメラ(CharaCam_Shoulder_Right_Mid, PID_アルフレッド, cam_anim_track2_r_normal)\nキャラモーション再生(PID_アイビー, Normal, EmoThink,,1)
MID_RELIANCE_A_#021	
MID_RELIANCE_A_#022	キャラモーション再生(PID_アイビー, Normal, EmoTalk2,,1)\n*\nキャラモーション再生(PID_アイビー, Normal, IdleNormal)
MID_RELIANCE_A_#023	キャラカメラ(CharaCam_Side_Left2_Mid, PID_アルフレッド, cam_anim_track_r_slow)\nキャラモーション再生(PID_アルフレッド, Die, EmoNod,,1)\nキャラモーション再生(PID_アルフレッド, Relax, IdleNormal, 1.5, 1)\n*\nキャラモーション再生(PID_アルフレッド, Smile, IdleNormal)
MID_RELIANCE_A_#024	キャラカメラ(CharaCam_Side_Right2_Mid, PID_アイビー, cam_anim_pan_r_slow)
MID_RELIANCE_A_#025	キャラモーション再生(PID_アイビー, Normal, EmoDeny2,,1)
MID_RELIANCE_A_#026	キャラモーション再生(PID_アイビー, Smile, EmoPray,,1)\n*\nキャラモーション再生(PID_アイビー, Smile, IdleNormal,,1)
MID_RELIANCE_A_#027	キャラカメラ(CharaCam_FrontLong2_Left_Mid, PID_アルフレッド, cam_anim_pan_l_slow)\nキャラモーション再生(PID_アルフレッド, Smile, EmoRelax,,1)\n*\nキャラモーション再生(PID_アルフレッド, Normal, IdleNormal,,1)
MID_RELIANCE_A_#028	キャラカメラ(CharaCam_FrontLong2_Right_Mid, PID_アイビー, cam_anim_pan_r_slow)
MID_RELIANCE_A_#029	キャラモーション再生(PID_アイビー, Smile, EmoRelax,,1)
MID_RELIANCE_A_#030	キャラカメラ(CharaCam_Side_Right2_Mid, PID_アイビー, cam_anim_zoom_in_slow)\n*\nフェードアウト()
