MID_RELIANCE_C_#001	キャラ配置(PID_ボネ, ME_IN_C,, Normal, IdleNormal)\nキャラ配置(PID_アンナ, YOU_IN_C,, Normal, IdleNormal, 130)\n\n背景(Map_Event_Hub_Solanel_06_Day)\nライト(CharaLight_Hub_Day)\n\nキャラ視線(PID_ボネ, PID_アンナ, PID_アンナ)\n\n一枚絵表示(Tex_Event_Effect_Black)\nフェードイン()\n*\nウェイト(2)
MID_RELIANCE_C_#002	キャラカメラ(CharaCam_ShoulderLong_Right_Bot, PID_アンナ, cam_anim_pan_r_slow)\n一枚絵非表示()\nキャラモーション再生(PID_ボネ, , WalkIn2)\nキャラ視線(PID_アンナ, PID_ボネ, PID_ボネ, 1)\n*\nキャラ視線(PID_アンナ, PID_ボネ, PID_ボネ)
MID_RELIANCE_C_#003	キャラモーション再生(PID_ボネ, , EmoProud,,1)\n*\nキャラモーション再生(PID_ボネ, Normal, IdleNormal,,1)
MID_RELIANCE_C_#004	キャラカメラ(CharaCam_FrontLong2_Left_Top, PID_アンナ, cam_anim_pan_l_normal)\nキャラモーション再生(PID_アンナ, Smile, TurnL,, 0.3)\nキャラモーション再生(PID_アンナ, Smile, EmoProud, 2, 1)\nキャラ回転(PID_アンナ, -130, 1.5)
MID_RELIANCE_C_#005	キャラモーション再生(PID_アンナ, , EmoTalk,,1)\n*\nキャラモーション再生(PID_アンナ, Normal, IdleNormal)
MID_RELIANCE_C_#006	キャラカメラ(CharaCam_SideLong_Right2_Mid, PID_ボネ, cam_anim_track3_l_normal)\nキャラモーション再生(PID_ボネ, , IdleNormal,,1)
MID_RELIANCE_C_#007	キャラモーション再生(PID_ボネ, , EmoTalk2,,1)\n*\nキャラモーション再生(PID_ボネ, Normal, IdleNormal)
MID_RELIANCE_C_#008	キャラカメラ(CharaCam_Side_Left2_Top, PID_アンナ, cam_anim_track_r_normal)\nキャラモーション再生(PID_アンナ, , EmoJoy,,1)\n*\nキャラモーション再生(PID_アンナ, Normal, IdleNormal,,1)
MID_RELIANCE_C_#009	キャラカメラ(CharaCam_FrontLong2_Right_Bot, PID_ボネ, cam_anim_pan_r_normal)\nキャラモーション再生(PID_ボネ, , EmoThink,,1)\n*\nキャラモーション再生(PID_ボネ, Normal, IdleNormal,,1)
MID_RELIANCE_C_#010	キャラカメラ(CharaCam_FrontLong2_Left_Top, PID_アンナ, cam_anim_pan_l_normal)\nキャラモーション再生(PID_アンナ, , EmoThink,,1)\n*\nキャラモーション再生(PID_アンナ, Surprise, IdleNormal)
MID_RELIANCE_C_#011	キャラカメラ(CharaCam_SideLong_Right2_Mid, PID_ボネ, cam_anim_track3_r_normal)\nキャラモーション再生(PID_ボネ, , EmoDeny2,,1)
MID_RELIANCE_C_#012	キャラモーション再生(PID_ボネ, , EmoThink,,1)
MID_RELIANCE_C_#013	キャラカメラ(CharaCam_Side_Right2_Mid, PID_ボネ, cam_anim_zoom_in_slow)\nキャラモーション再生(PID_ボネ, , EmoNod,,1)
MID_RELIANCE_C_#014	キャラモーション再生(PID_ボネ, , EmoRelax,,1)\n*\nキャラモーション再生(PID_ボネ, Relax, IdleNormal)
MID_RELIANCE_C_#015	キャラカメラ(CharaCam_Side_Left3_Top, PID_アンナ, cam_anim_track_l_normal)\nキャラモーション再生(PID_アンナ, Relax, EmoNod, 3, 1)
MID_RELIANCE_C_#016	キャラモーション再生(PID_アンナ, Relax, EmoProud,,1)\n*\nキャラモーション再生(PID_アンナ, Normal, IdleNormal,,1)
MID_RELIANCE_C_#017	キャラカメラ(CharaCam_FrontLong2_Right_Bot, PID_ボネ, cam_anim_pan_l_slow)\nキャラモーション再生(PID_ボネ, , EmoThink,,1)\n*\nキャラモーション再生(PID_ボネ, Relax, IdleNormal,,1)
MID_RELIANCE_C_#018	キャラカメラ(CharaCam_FrontLong2_Left_Top, PID_アンナ, cam_anim_pan_l_normal)\nキャラモーション再生(PID_アンナ, , EmoJoy,,1)\n*\nキャラモーション再生(PID_アンナ, Normal, IdleNormal)
MID_RELIANCE_C_#019	キャラカメラ(CharaCam_Side_Right3_Bot, PID_ボネ, cam_anim_track_r_normal)\nキャラモーション再生(PID_ボネ, , EmoTalk,,1)\n*\nフェードアウト()
MID_RELIANCE_B_#001	キャラ配置(PID_ボネ, ME_IN_C,, Normal, IdleNormal)\nキャラ配置(PID_アンナ, YOU_IN_C,, Normal, IdleNormal, 130)\n\n背景(Map_Event_Hub_Solanel_06_Day)\nライト(CharaLight_Hub_Day)\n\nキャラ視線(PID_ボネ, PID_アンナ, PID_アンナ)\n\n一枚絵表示(Tex_Event_Effect_Black)\nフェードイン()\n*\nウェイト(2)
MID_RELIANCE_B_#002	キャラカメラ(CharaCam_ShoulderLong_Right_Bot, PID_アンナ, cam_anim_pan_r_slow)\n一枚絵非表示()\nキャラモーション再生(PID_ボネ, , WalkIn2)\nキャラ視線(PID_アンナ, PID_ボネ, PID_ボネ, 1)\n*\nキャラモーション再生(PID_ボネ, Relax, IdleNormal,,1)\nキャラ視線(PID_アンナ, PID_ボネ, PID_ボネ)
MID_RELIANCE_B_#003	キャラカメラ(CharaCam_FrontLong2_Left_Top, PID_アンナ, cam_anim_pan_l_normal)\nキャラモーション再生(PID_アンナ, , TurnL,, 0.3)\nキャラ回転(PID_アンナ, -130, 1.5)\n*\nキャラモーション再生(PID_アンナ, Relax, IdleNormal)
MID_RELIANCE_B_#004	キャラカメラ(CharaCam_SideLong_Right2_Mid, PID_ボネ, cam_anim_track3_r_normal)\nキャラモーション再生(PID_ボネ, , EmoNod,,1)
MID_RELIANCE_B_#005	キャラモーション再生(PID_ボネ, , EmoTalk2,,1)
MID_RELIANCE_B_#006	キャラモーション再生(PID_ボネ, , EmoJoy,,1)\n*\nキャラモーション再生(PID_ボネ, Normal, IdleNormal)
MID_RELIANCE_B_#007	キャラカメラ(CharaCam_Side_Left2_Top, PID_アンナ, cam_anim_track_r_normal)\nキャラモーション再生(PID_アンナ, , EmoJoy,,1)\n*\nキャラモーション再生(PID_アンナ, Normal, IdleNormal,,1)
MID_RELIANCE_B_#008	キャラカメラ(CharaCam_FrontLong2_Right_Bot, PID_ボネ, cam_anim_pan_l_slow)\nキャラモーション再生(PID_ボネ, , EmoTalk2,,1)\n*\nキャラモーション再生(PID_ボネ, , IdleNormal)\nキャラ表示切替(PID_ボネ, False)
MID_RELIANCE_B_#009	キャラカメラ(CharaCam_SideLong_Left2_Mid, PID_アンナ, cam_anim_track3_l_normal)\nキャラモーション再生(PID_アンナ, , EmoThink,,1)\nキャラ視線リセット(PID_アンナ)
MID_RELIANCE_B_#010	キャラモーション再生(PID_アンナ, , EmoSad2,,1)\n*\nキャラモーション再生(PID_アンナ, Relax, IdleNormal)\nキャラ表示切替(PID_ボネ, True)
MID_RELIANCE_B_#011	キャラカメラ(CharaCam_Side_Right2_Mid, PID_ボネ, cam_anim_track_l_normal)\n*\nキャラモーション再生(PID_ボネ, Surprise, IdleNormal)
MID_RELIANCE_B_#012	キャラカメラ(CharaCam_Side_Left2_Top, PID_アンナ, cam_anim_track_r_normal)\nキャラモーション再生(PID_アンナ, Sad, EmoSad, 3, 1)
MID_RELIANCE_B_#013	キャラモーション再生(PID_アンナ, Sad, TurnR,, 0.8)\nキャラ回転(PID_アンナ, 180, 1.3)\n*\nキャラモーション再生(PID_アンナ, Normal, IdleNormal)
MID_RELIANCE_B_#014	キャラカメラ(CharaCam_Side_Right2_Mid, PID_ボネ, cam_anim_zoom_in_slow)\n*\nキャラモーション再生(PID_ボネ, Normal, IdleNormal,,1)
MID_RELIANCE_B_#015	キャラカメラ(CharaCam_FrontLong2_Left_Top, PID_アンナ, cam_anim_pan_l_normal)\nキャラモーション再生(PID_アンナ, , EmoDeny2,,1)\nキャラモーション再生(PID_アンナ, , EmoJoy, 2, 1)\n*\nキャラモーション再生(PID_アンナ, Normal, IdleNormal)
MID_RELIANCE_B_#016	キャラカメラ(CharaCam_Side_Right3_Mid, PID_ボネ, cam_anim_zoom_in_slow)\nキャラモーション再生(PID_ボネ, , EmoThink,,1)\n*\nフェードアウト()
MID_RELIANCE_A_#001	キャラ配置(PID_ボネ, ME_IN_C,, Normal, IdleNormal)\nキャラ配置(PID_アンナ, YOU_IN_C,, Normal, IdleNormal, 160)\nキャラ表示切替(PID_ボネ, False)\n\n背景(Map_Event_Hub_Solanel_06_Day)\nライト(CharaLight_Hub_Day)\n\nキャラ視線(PID_ボネ, PID_アンナ, PID_アンナ)\n\n一枚絵表示(Tex_Event_Effect_Black)\nフェードイン()
MID_RELIANCE_A_#002	キャラカメラ(CharaCam_Back_Center_Top, PID_アンナ, cam_anim_track_r_normal)\n一枚絵非表示()\n\nキャラモーション再生(PID_アンナ, , EmoSad2,,1)
MID_RELIANCE_A_#003	キャラモーション再生(PID_アンナ, Sad, IdleNormal,,1)
MID_RELIANCE_A_#004	キャラモーション再生(PID_アンナ, Die, EmoDeny2,,1)\nキャラモーション再生(PID_アンナ, Sad,,2)\n*\nキャラモーション再生(PID_アンナ, Sad, IdleNormal,,1)\nキャラ表示切替(PID_ボネ, True)
MID_RELIANCE_A_#005	キャラカメラ(CharaCam_FrontLong2_Right_Bot, PID_ボネ, cam_anim_pan_r_normal)\nキャラモーション再生(PID_ボネ, , WalkIn2)\n*\nキャラモーション再生(PID_ボネ, Normal, IdleNormal,,1)
MID_RELIANCE_A_#006	キャラカメラ(CharaCam_FrontLong2_Left_Top, PID_アンナ, cam_anim_pan_l_normal)\nキャラモーション再生(PID_アンナ, Normal, TurnL,, 0.3)\nキャラ回転(PID_アンナ, -160, 1.5)\nキャラ視線(PID_アンナ, PID_ボネ, PID_ボネ)
MID_RELIANCE_A_#007	キャラモーション再生(PID_アンナ, Sad, EmoSad,,1)\n*\nキャラモーション再生(PID_アンナ, Surprise, IdleNormal)
MID_RELIANCE_A_#008	キャラカメラ(CharaCam_Side_Right3_Mid, PID_ボネ, cam_anim_track_r_normal)\nキャラモーション再生(PID_ボネ, , EmoDeny2,,1)
MID_RELIANCE_A_#009	キャラモーション再生(PID_ボネ, Relax, EmoTalk,,1)\n*\nキャラモーション再生(PID_ボネ, , IdleNormal)
MID_RELIANCE_A_#010	キャラカメラ(CharaCam_Side_Left3_Top, PID_アンナ, cam_anim_track_l_normal)\nキャラモーション再生(PID_アンナ, Smile,,2)\n*\nキャラモーション再生(PID_アンナ, Smile)\nキャラ視線リセット(PID_アンナ)
MID_RELIANCE_A_#011	キャラカメラ(CharaCam_FrontLong2_Right_Bot, PID_ボネ, cam_anim_pan_r_normal)\nキャラモーション再生(PID_ボネ, , EmoNod,,1)\n*\nキャラモーション再生(PID_ボネ, Relax, IdleNormal)
MID_RELIANCE_A_#012	キャラカメラ(CharaCam_Side_Left2_Mid, PID_アンナ, cam_anim_zoom_in_slow)\n*\nパペット会話中断()\n一枚絵表示(Tex_Event_Effect_Black)\nウェイト(1)\nキャラモーション再生(PID_アンナ, Relax, IdleNormal,,1)
MID_RELIANCE_A_#013	
MID_RELIANCE_A_#014	キャラカメラ(CharaCam_Front_Center_Top, PID_アンナ, cam_anim_pan_u_normal)\n一枚絵非表示()\nキャラモーション再生(PID_アンナ, , EmoThink,,1)\n*\nキャラモーション再生(PID_アンナ, Relax, IdleNormal)\nキャラ視線(PID_アンナ, PID_ボネ, PID_ボネ)
MID_RELIANCE_A_#015	キャラカメラ(CharaCam_SideLong_Right2_Mid, PID_ボネ, cam_anim_track3_r_normal)\nキャラモーション再生(PID_ボネ, , EmoNod,,1)
MID_RELIANCE_A_#016	キャラモーション再生(PID_ボネ, Normal, EmoThink,,1)
MID_RELIANCE_A_#017	*\nキャラモーション再生(PID_ボネ, Normal, IdleNormal,,1)
MID_RELIANCE_A_#018	キャラカメラ(CharaCam_FrontLong2_Left_Top, PID_アンナ, cam_anim_pan_l_normal)\nキャラモーション再生(PID_アンナ, , EmoRelax,,1)
MID_RELIANCE_A_#019	キャラモーション再生(PID_アンナ, Shy, EmoSad2,,1)
MID_RELIANCE_A_#020	キャラカメラ(CharaCam_Side_Left2_Top, PID_アンナ, cam_anim_zoom_in_slow)\nキャラモーション再生(PID_アンナ, Relax, EmoJoy,,1)\n*\nキャラモーション再生(PID_アンナ, , IdleNormal,,1)
MID_RELIANCE_A_#021	キャラカメラ(CharaCam_FrontLong2_Right_Bot, PID_ボネ, cam_anim_pan_r_normal)\nキャラモーション再生(PID_ボネ, , EmoTalk2,,1)\n*\nキャラモーション再生(PID_ボネ, Relax, IdleNormal,,1)
MID_RELIANCE_A_#022	キャラカメラ(CharaCam_FrontLong2_Left_Top, PID_アンナ, cam_anim_pan_l_normal)\nキャラモーション再生(PID_アンナ, , EmoPray,,1)\n*\nキャラモーション再生(PID_アンナ, Normal, IdleNormal)
MID_RELIANCE_A_#023	キャラカメラ(CharaCam_Side_Right2_Mid, PID_ボネ, cam_anim_track_l_normal)\nキャラモーション再生(PID_ボネ, , EmoDeny2,,1)\n*\nキャラモーション再生(PID_ボネ, , IdleNormal)\nキャラ表示切替(PID_ボネ, False)
MID_RELIANCE_A_#024	キャラカメラ(CharaCam_SideLong_Left2_Mid, PID_アンナ, cam_anim_track3_l_normal)\nキャラモーション再生(PID_アンナ, , EmoThink,,1)
MID_RELIANCE_A_#025	キャラモーション再生(PID_アンナ, , EmoTalk,,1)\n*\nキャラモーション再生(PID_アンナ, Smile, IdleNormal,,1)\nキャラ表示切替(PID_ボネ, True)
MID_RELIANCE_A_#026	キャラカメラ(CharaCam_FrontLong2_Right_Bot, PID_ボネ, cam_anim_track3_r_normal)\nキャラモーション再生(PID_ボネ, Relax, EmoSad,,1)
MID_RELIANCE_A_#027	キャラモーション再生(PID_ボネ, Smile, EmoTalk,,1)\n*\nキャラモーション再生(PID_ボネ, Normal, IdleNormal)
MID_RELIANCE_A_#028	キャラカメラ(CharaCam_Side_Left2_Top, PID_アンナ, cam_anim_track_r_normal)\nキャラモーション再生(PID_アンナ, , EmoProud,,1)\n*\nフェードアウト()
