MID_RELIANCE_C_#001	キャラ配置(PID_ブシュロン, ME_IN_C,, Sad)\nキャラ配置(PID_リンデン, YOU_IN_C)\n\n背景(Map_Event_Hub_Solanel_01_Day)\nライト(CharaLight_Hub_Day)\n\nキャラ視線(PID_ブシュロン, PID_リンデン, PID_リンデン)\nキャラ視線(PID_リンデン, PID_ブシュロン, PID_ブシュロン)\n\nキャラ表示切替(PID_リンデン, False)\n\nキャラカメラ(CharaCam_FrontLong2_Right_Top, PID_ブシュロン, cam_anim_track_l_normal)\nフェードイン()\n\nキャラモーション再生(PID_ブシュロン, , EmoSad,,1)\n*\nキャラモーション再生(PID_ブシュロン, , IdleNormal,,1)\nキャラ表示切替(PID_リンデン, True)
MID_RELIANCE_C_#002	キャラカメラ(CharaCam_FrontLong2_Left_Mid, PID_リンデン, cam_anim_pan_l_normal)\nキャラモーション再生(PID_リンデン, , WalkIn2)\n*\nキャラモーション再生(PID_リンデン, , IdleNormal,,1)
MID_RELIANCE_C_#003	キャラカメラ(CharaCam_FrontLong2_Right_Mid, PID_ブシュロン, cam_anim_pan_r_normal)\nキャラモーション再生(PID_ブシュロン, , EmoTalk,,1)
MID_RELIANCE_C_#004	キャラモーション再生(PID_ブシュロン, , EmoShy,,1)\n*\nキャラモーション再生(PID_ブシュロン, Normal, IdleNormal)
MID_RELIANCE_C_#005	キャラカメラ(CharaCam_Side_Left3_Mid, PID_リンデン, cam_anim_track_l_normal)\nキャラモーション再生(PID_リンデン, , EmoThink,,1)\n*\nキャラモーション再生(PID_リンデン, , IdleNormal)
MID_RELIANCE_C_#006	キャラカメラ(CharaCam_Side_Right3_Mid, PID_ブシュロン, cam_anim_track_r_normal)\n*\nキャラ表示切替(PID_ブシュロン, False)
MID_RELIANCE_C_#007	キャラカメラ(CharaCam_SideLong_Left2_Mid, PID_リンデン, cam_anim_track3_l_normal)\nキャラモーション再生(PID_リンデン, , EmoTalk,,1)\n*\nキャラモーション再生(PID_リンデン, Die, IdleNormal)\nキャラ表示切替(PID_ブシュロン, True)
MID_RELIANCE_C_#008	キャラカメラ(CharaCam_Side_Left3_Bot, PID_ブシュロン, cam_anim_zoom_in_slow)\nキャラモーション再生(PID_ブシュロン, , EmoThinkIn,,1)
MID_RELIANCE_C_#009	キャラカメラ(CharaCam_Side_Right3_Top, PID_ブシュロン, cam_anim_track_r_normal)
MID_RELIANCE_C_#010	キャラカメラ(CharaCam_Side_Left2_Mid, PID_リンデン, cam_anim_track_r_normal)\nキャラモーション再生(PID_リンデン, , EmoNod,,1)\nキャラモーション再生(PID_リンデン, Normal,,2)\n*\nキャラモーション再生(PID_リンデン, Normal, IdleNormal,,1)
MID_RELIANCE_C_#011	キャラカメラ(CharaCam_FrontLong2_Right_Mid, PID_ブシュロン, cam_anim_track3_r_normal)\nキャラモーション再生(PID_ブシュロン, , EmoTalk,,1)
MID_RELIANCE_C_#012	キャラモーション再生(PID_ブシュロン, Sad)
MID_RELIANCE_C_#013	キャラカメラ(CharaCam_SideLong_Right2_Mid, PID_ブシュロン, cam_anim_pan_u_slow)\nキャラモーション再生(PID_ブシュロン, , EmoShy, 3, 1)\n*\nキャラモーション再生(PID_ブシュロン, , IdleNormal,,1)
MID_RELIANCE_C_#014	キャラカメラ(CharaCam_FrontLong2_Left_Mid, PID_リンデン, cam_anim_pan_l_normal)\nキャラモーション再生(PID_リンデン, , EmoGive,,1)\n*\nキャラモーション再生(PID_リンデン, Smile, IdleNormal,,1)
MID_RELIANCE_C_#015	キャラカメラ(CharaCam_FrontLong2_Right_Mid, PID_ブシュロン, cam_anim_pan_r_normal)\nキャラモーション再生(PID_ブシュロン, , EmoSad,,1)
MID_RELIANCE_C_#016	
MID_RELIANCE_C_#017	キャラカメラ(CharaCam_Side_Right3_Mid, PID_ブシュロン, cam_anim_zoom_in_slow)\nキャラモーション再生(PID_ブシュロン, , EmoDeny2,,1)\n*\nキャラモーション再生(PID_ブシュロン, Normal, IdleNormal,,1)
MID_RELIANCE_C_#018	キャラカメラ(CharaCam_FrontLong2_Left_Mid, PID_リンデン, cam_anim_pan_l_normal)\nキャラモーション再生(PID_リンデン, , EmoTalk,,1)\n*\nキャラモーション再生(PID_リンデン, , IdleNormal,,1)
MID_RELIANCE_C_#019	キャラカメラ(CharaCam_Shoulder_Left_Top, PID_ブシュロン, cam_anim_track_l_normal)\nキャラモーション再生(PID_ブシュロン, , EmoThink, 2.5, 1)\nキャラモーション再生(PID_リンデン, Surprise,,3)\n*\nキャラモーション再生(PID_ブシュロン, Normal, IdleNormal)
MID_RELIANCE_C_#020	キャラカメラ(CharaCam_Side_Left3_Mid, PID_リンデン, cam_anim_zoom_in_slow)\nキャラモーション再生(PID_リンデン, Sad, EmoSad,,1)\n*\nフェードアウト()
MID_RELIANCE_B_#001	キャラ配置(PID_ブシュロン, ME_IN_C)\nキャラ配置(PID_リンデン, YOU_IN_C)\n\n背景(Map_Event_Hub_Solanel_01_Day)\nライト(CharaLight_Hub_Day)\n\nキャラ視線(PID_ブシュロン, PID_リンデン, PID_リンデン)\nキャラ視線(PID_リンデン, PID_ブシュロン, PID_ブシュロン)\n\nシーンカメラ(SceneCam_SideMe_Left_Mid, cam_anim_zoom_in_slow)\nフェードイン()\n\nキャラモーション再生(PID_リンデン, , EmoTalk,,1)
MID_RELIANCE_B_#002	キャラモーション再生(PID_リンデン, , EmoGive,,1)\n*\nキャラモーション再生(PID_リンデン, Smile, IdleNormal)
MID_RELIANCE_B_#003	キャラカメラ(CharaCam_Side_Right3_Bot, PID_ブシュロン, cam_anim_track_r_slow)
MID_RELIANCE_B_#004	キャラカメラ(CharaCam_FrontLong2_Left_Mid, PID_リンデン, cam_anim_pan_l_normal)\nキャラモーション再生(PID_リンデン, , EmoJoy,,1)\n*\nキャラモーション再生(PID_リンデン, Normal, IdleNormal,,1)
MID_RELIANCE_B_#005	キャラカメラ(CharaCam_FrontLong2_Right_Mid, PID_ブシュロン, cam_anim_pan_r_normal)\nキャラモーション再生(PID_ブシュロン, , EmoTalk,,1)\n*\nキャラモーション再生(PID_ブシュロン, , IdleNormal,,1)
MID_RELIANCE_B_#006	キャラカメラ(CharaCam_FrontLong2_Left_Mid, PID_リンデン, cam_anim_pan_l_normal)\nキャラモーション再生(PID_リンデン, , EmoTalk2,,1)\n*\nキャラモーション再生(PID_リンデン, Smile, IdleNormal)
MID_RELIANCE_B_#007	キャラカメラ(CharaCam_Side_Right3_Mid, PID_ブシュロン, cam_anim_zoom_in_slow)\nキャラモーション再生(PID_ブシュロン, , EmoNod,,1)\n*\nパペット会話中断()\nキャラモーション再生(PID_ブシュロン, , EmoPray,,1)\nウェイト(2)
MID_RELIANCE_B_#008	キャラカメラ(CharaCam_Side_Right2_Mid, PID_ブシュロン, cam_anim_track_l_normal)\nキャラモーション再生(PID_ブシュロン, Smile, EmoNod,,1)\n*\nキャラモーション再生(PID_ブシュロン, Normal, IdleNormal)\nキャラ表示切替(PID_ブシュロン, False)
MID_RELIANCE_B_#009	キャラカメラ(CharaCam_SideLong_Left2_Mid, PID_リンデン, cam_anim_pan_u_slow)\nキャラモーション再生(PID_リンデン, , EmoProud,,1)\n*\nキャラモーション再生(PID_リンデン, Normal, EmoThinkLoop)\nキャラ表示切替(PID_ブシュロン, True)
MID_RELIANCE_B_#010	キャラカメラ(CharaCam_Side_Left3_Bot, PID_ブシュロン, cam_anim_zoom_in_slow)\nキャラモーション再生(PID_ブシュロン, , EmoThinkIn,,1)
MID_RELIANCE_B_#011	
MID_RELIANCE_B_#012	キャラカメラ(CharaCam_Side_Right3_Top, PID_ブシュロン, cam_anim_track_r_normal)
MID_RELIANCE_B_#013	キャラモーション再生(PID_ブシュロン, , IdleNormal,,1)\n*\nキャラモーション再生(PID_ブシュロン, Sad)
MID_RELIANCE_B_#014	キャラカメラ(CharaCam_Side_Left2_Mid, PID_リンデン, cam_anim_track_r_normal)
MID_RELIANCE_B_#015	キャラモーション再生(PID_リンデン, , IdleNormal,,1)\n*\nキャラモーション再生(PID_リンデン, Normal, IdleNormal,,1)
MID_RELIANCE_B_#016	キャラカメラ(CharaCam_FrontLong2_Right_Mid, PID_ブシュロン, cam_anim_pan_r_normal)\nキャラモーション再生(PID_ブシュロン, , EmoDeny2,,1)
MID_RELIANCE_B_#017	キャラモーション再生(PID_ブシュロン, Sad, EmoShy,,1)\n*\nキャラモーション再生(PID_ブシュロン, , IdleNormal,,1)
MID_RELIANCE_B_#018	キャラカメラ(CharaCam_FrontLong2_Left_Mid, PID_リンデン, cam_anim_pan_l_normal)
MID_RELIANCE_B_#019	キャラモーション再生(PID_リンデン, , EmoTalk,,1)\n*\nキャラモーション再生(PID_リンデン, Surprise, IdleNormal,,1)
MID_RELIANCE_B_#020	キャラカメラ(CharaCam_FrontLong2_Right_Mid, PID_ブシュロン, cam_anim_pan_r_normal)
MID_RELIANCE_B_#021	キャラカメラ(CharaCam_Side_Right3_Mid, PID_ブシュロン, cam_anim_zoom_in_fast)\nキャラモーション再生(PID_ブシュロン, , EmoSad,,1)\n*\nキャラモーション再生(PID_ブシュロン, , IdleNormal,,1)
MID_RELIANCE_B_#022	キャラカメラ(CharaCam_FrontLong2_Left_Mid, PID_リンデン, cam_anim_pan_l_normal)\nキャラモーション再生(PID_リンデン, , EmoGive,,1)\n*\nキャラモーション再生(PID_リンデン, Normal, IdleNormal,,1)
MID_RELIANCE_B_#023	キャラカメラ(CharaCam_FrontLong2_Right_Mid, PID_ブシュロン, cam_anim_pan_r_normal)\nキャラモーション再生(PID_ブシュロン, , EmoThink, 3, 1)\nキャラカメラ(CharaCam_Back_Center_Top, PID_ブシュロン, cam_anim_pan_u_slow, 3)\n*\nフェードアウト()
MID_RELIANCE_A_#001	キャラ配置(PID_ブシュロン, ME_IN_C,, Smile)\nキャラ配置(PID_リンデン, YOU_IN_C,, Smile)\n\n背景(Map_Event_Hub_Solanel_01_Day)\nライト(CharaLight_Hub_Day)\n\nキャラ視線(PID_ブシュロン, PID_リンデン, PID_リンデン)\nキャラ視線(PID_リンデン, PID_ブシュロン, PID_ブシュロン)\n\nキャラカメラ(CharaCam_FrontLong2_Left_Mid, PID_リンデン, cam_anim_pan_l_normal)\nフェードイン()\n\nキャラモーション再生(PID_リンデン, , EmoTalk,,1)\n*\nキャラモーション再生(PID_リンデン, Normal, IdleNormal,,1)
MID_RELIANCE_A_#002	キャラカメラ(CharaCam_FrontLong2_Right_Mid, PID_ブシュロン, cam_anim_pan_r_normal)\nキャラモーション再生(PID_ブシュロン, , EmoPray,,1)\nキャラカメラ(CharaCam_Side_Right3_Mid, PID_ブシュロン, cam_anim_zoom_in_slow, 4)\nキャラモーション再生(PID_ブシュロン, , EmoNod, 4, 1)\n*\nキャラモーション再生(PID_ブシュロン, Normal, IdleNormal)
MID_RELIANCE_A_#003	キャラカメラ(CharaCam_Side_Left3_Mid, PID_リンデン, cam_anim_track_l_normal)\nキャラモーション再生(PID_リンデン, , EmoThink,,1)\n*\nキャラモーション再生(PID_リンデン, Normal, IdleNormal,,1)
MID_RELIANCE_A_#004	キャラカメラ(CharaCam_FrontLong2_Right_Mid, PID_ブシュロン, cam_anim_pan_r_normal)
MID_RELIANCE_A_#005	キャラカメラ(CharaCam_Side_Left3_Mid, PID_リンデン, cam_anim_zoom_in_slow)\nキャラモーション再生(PID_リンデン, , EmoNod,,1)\n*\nキャラモーション再生(PID_リンデン, Sad, IdleNormal,,1)
MID_RELIANCE_A_#006	キャラカメラ(CharaCam_FrontLong2_Right_Mid, PID_ブシュロン, cam_anim_pan_r_normal)\nキャラモーション再生(PID_ブシュロン, , EmoTalk,,1)
MID_RELIANCE_A_#007	キャラモーション再生(PID_ブシュロン, , EmoPray,,1)
MID_RELIANCE_A_#008	キャラカメラ(CharaCam_SideLong_Right2_Mid, PID_ブシュロン, cam_anim_pan_u_slow)\nキャラモーション再生(PID_ブシュロン, Sad)
MID_RELIANCE_A_#009	キャラモーション再生(PID_ブシュロン, , EmoThinkIn,,1)
MID_RELIANCE_A_#010	キャラカメラ(CharaCam_Side_Right3_Mid, PID_ブシュロン, cam_anim_zoom_in_slow)
MID_RELIANCE_A_#011	キャラモーション再生(PID_ブシュロン, , EmoSad,,1)\n*\nキャラモーション再生(PID_ブシュロン, Normal, IdleNormal,,1)
MID_RELIANCE_A_#012	キャラカメラ(CharaCam_FrontLong2_Left_Mid, PID_リンデン, cam_anim_pan_l_normal)\nキャラモーション再生(PID_リンデン, , EmoSad,,1)\n*\nキャラモーション再生(PID_リンデン, Normal, IdleNormal,,1)
MID_RELIANCE_A_#013	キャラカメラ(CharaCam_FrontLong2_Right_Mid, PID_ブシュロン, cam_anim_pan_l_normal)\nキャラモーション再生(PID_ブシュロン, , EmoTalk,,1)\n*\nキャラモーション再生(PID_ブシュロン, Normal, IdleNormal,,1)
MID_RELIANCE_A_#014	キャラカメラ(CharaCam_SideLong_Left2_Mid, PID_リンデン, cam_anim_track_l_normal)\nキャラモーション再生(PID_リンデン, , EmoTalk,,1)\n*\nキャラモーション再生(PID_リンデン, Normal, IdleNormal)
MID_RELIANCE_A_#015	キャラカメラ(CharaCam_Side_Right2_Mid, PID_ブシュロン, cam_anim_track_l_normal)\nキャラモーション再生(PID_ブシュロン, , IdleNormal,,1)\n*\nキャラモーション再生(PID_ブシュロン, Surprise)
MID_RELIANCE_A_#016	キャラカメラ(CharaCam_FrontLong2_Left_Mid, PID_リンデン, cam_anim_pan_l_normal)\nキャラモーション再生(PID_リンデン, , EmoThink,,1)
MID_RELIANCE_A_#017	キャラモーション再生(PID_リンデン, , EmoSad,,1)\n*\nキャラモーション再生(PID_リンデン, Normal, IdleNormal,,1)
MID_RELIANCE_A_#018	キャラカメラ(CharaCam_FrontLong2_Right_Mid, PID_ブシュロン, cam_anim_pan_l_normal)\nキャラモーション再生(PID_ブシュロン, , EmoTalk,,1)\n*\nキャラモーション再生(PID_ブシュロン, Normal, IdleNormal,,1)
MID_RELIANCE_A_#019	キャラカメラ(CharaCam_FrontLong2_Left_Mid, PID_リンデン, cam_anim_pan_r_normal)\nキャラモーション再生(PID_リンデン, , EmoTalk,,1)\n*\nキャラモーション再生(PID_リンデン, Smile, IdleNormal)
MID_RELIANCE_A_#020	キャラカメラ(CharaCam_Side_Right2_Mid, PID_ブシュロン, cam_anim_track_l_normal)\nキャラモーション再生(PID_ブシュロン, , EmoNod,,1)\n*\nキャラモーション再生(PID_ブシュロン, Smile, IdleNormal)
MID_RELIANCE_A_#021	キャラカメラ(CharaCam_Side_Left3_Mid, PID_リンデン, cam_anim_zoom_in_slow)\nキャラモーション再生(PID_リンデン, , EmoPray,,1)\n*\nキャラモーション再生(PID_リンデン, Normal, IdleNormal,,1)
MID_RELIANCE_A_#022	キャラカメラ(CharaCam_FrontLong2_Right_Mid, PID_ブシュロン, cam_anim_pan_r_normal)\nキャラモーション再生(PID_ブシュロン, , EmoPray,,1)\n*\nキャラモーション再生(PID_ブシュロン, Normal, IdleNormal)\nキャラ表示切替(PID_ブシュロン, False)
MID_RELIANCE_A_#023	キャラカメラ(CharaCam_SideLong_Left2_Mid, PID_リンデン, cam_anim_pan_u_slow)\nキャラモーション再生(PID_リンデン, , EmoProud,,1)
MID_RELIANCE_A_#024	キャラモーション再生(PID_リンデン, Smile, EmoJoy,,1)\n*\nキャラモーション再生(PID_リンデン, Normal, IdleNormal)\nキャラ表示切替(PID_ブシュロン, True)
MID_RELIANCE_A_#025	キャラカメラ(CharaCam_Side_Right3_Mid, PID_ブシュロン, cam_anim_zoom_in_slow)\nキャラモーション再生(PID_ブシュロン, Smile, EmoTalk,,1)\n*\nフェードアウト()
