MID_RELIANCE_C_#001	キャラ配置(PID_セリーヌ, ME_IN_C,, Relax, IdleNormal)\nキャラ配置調整(PID_セリーヌ, 0, 0.05, 0)\nキャラ配置(PID_オルテンシア, YOU_IN_C,, Angry, IdleNormal)\n\n背景(Map_Event_Hub_Solanel_03_Day)\nライト(CharaLight_Hub_Day)\n\nキャラ視線(PID_セリーヌ, PID_オルテンシア, PID_オルテンシア)\nキャラ視線(PID_オルテンシア, PID_セリーヌ, PID_セリーヌ)\n\nウェイト(0.2)\n\nキャラカメラ(CharaCam_FrontLong2_Left_Mid, PID_セリーヌ, cam_anim_track3_l_normal)\nフェードイン()\nキャラモーション再生(PID_セリーヌ, , EmoTalk2,,1)\n*\nキャラモーション再生(PID_セリーヌ, Surprise, IdleNormal,,1)
MID_RELIANCE_C_#002	キャラカメラ(CharaCam_FrontLong2_Right_Mid, PID_オルテンシア, cam_anim_pan_r_normal)\nキャラモーション再生(PID_オルテンシア, , EmoSurprise2,,1)
MID_RELIANCE_C_#003	キャラモーション再生(PID_オルテンシア, , EmoThink,,1)
MID_RELIANCE_C_#004	キャラカメラ(CharaCam_Side_Right3_Mid, PID_オルテンシア, cam_anim_zoom_in_slow)\nキャラモーション再生(PID_オルテンシア, , EmoNod,,1)\n*\nキャラモーション再生(PID_オルテンシア, Normal, IdleNormal)
MID_RELIANCE_C_#005	キャラカメラ(CharaCam_Side_Left2_Mid, PID_セリーヌ, cam_anim_track_r_normal)\n*\nキャラモーション再生(PID_セリーヌ, Normal, IdleNormal,,1)
MID_RELIANCE_C_#006	キャラカメラ(CharaCam_Side_Right2_Top, PID_オルテンシア, cam_anim_track3_r_normal)\nキャラモーション再生(PID_オルテンシア, , EmoNod,,1)
MID_RELIANCE_C_#007	キャラモーション再生(PID_オルテンシア, , EmoThink,,1)
MID_RELIANCE_C_#008	キャラモーション再生(PID_オルテンシア, Angry, EmoSad2,,1)\n*\nキャラモーション再生(PID_オルテンシア, , IdleNormal)
MID_RELIANCE_C_#009	キャラカメラ(CharaCam_Side_Left2_Mid, PID_セリーヌ, cam_anim_zoom_in_slow)
MID_RELIANCE_C_#010	キャラカメラ(CharaCam_SideLong_Right2_Mid, PID_オルテンシア, cam_anim_track3_l_normal)\nキャラモーション再生(PID_オルテンシア, , EmoProud,,1)
MID_RELIANCE_C_#011	
MID_RELIANCE_C_#012	キャラカメラ(CharaCam_FrontLong2_Right_Mid, PID_オルテンシア, cam_anim_pan_l_slow)\nキャラモーション再生(PID_オルテンシア, , EmoJoy,,1)\n*\nキャラモーション再生(PID_オルテンシア, Surprise, IdleNormal)
MID_RELIANCE_C_#013	キャラカメラ(CharaCam_Side_Left3_Mid, PID_セリーヌ, cam_anim_zoom_in_slow)
MID_RELIANCE_C_#014	キャラモーション再生(PID_セリーヌ, Smile, IdleNormal,,1)\n*\nキャラモーション再生(PID_セリーヌ, Surprise, IdleNormal,,1)
MID_RELIANCE_C_#015	キャラカメラ(CharaCam_FrontLong2_Right_Mid, PID_オルテンシア, cam_anim_pan_r_normal)
MID_RELIANCE_C_#016	キャラモーション再生(PID_オルテンシア, Angry, EmoAngry,,0.5)
MID_RELIANCE_C_#017	キャラカメラ(CharaCam_Side_Right2_Mid, PID_オルテンシア, cam_anim_track3_r_normal)\nキャラモーション再生(PID_オルテンシア, , EmoJoy,,1)
MID_RELIANCE_C_#018	キャラモーション再生(PID_オルテンシア, Shy, EmoNod,,1)\n*\nパペット会話中断()\nキャラ視線リセット(PID_オルテンシア)\nキャラモーション再生(PID_オルテンシア, , WalkOut,, 0.7)\nキャラ回転(PID_オルテンシア, 180, 1.5)\nウェイト(2)\nキャラ表示切替(PID_オルテンシア, False)
MID_RELIANCE_C_#019	キャラカメラ(CharaCam_FrontLong2_Left_Mid, PID_セリーヌ, cam_anim_track_r_normal)
MID_RELIANCE_C_#020	キャラモーション再生(PID_セリーヌ, Relax, EmoRelax,,1)\n*\nフェードアウト()
MID_RELIANCE_B_#001	キャラ配置(PID_セリーヌ, YOU_IN_C,, Relax, IdleNormal)\nキャラ配置(PID_オルテンシア, ME_IN_C,, Angry, IdleNormal)\nキャラ配置調整(PID_セリーヌ, 0, 0.05, 0)\n\nキャラ配置(PID_デモ用_視線設定用, YOU_MID_C)\nキャラ配置調整(PID_デモ用_視線設定用, -1, -0.2, -2)\n\n背景(Map_Event_Hub_Solanel_01_Day)\nライト(CharaLight_Hub_Day)\n\nキャラ視線(PID_セリーヌ, PID_オルテンシア, PID_オルテンシア)\nキャラ視線(PID_オルテンシア, PID_セリーヌ, PID_セリーヌ)\n\nウェイト(0.2)\n\nキャラカメラ(CharaCam_FrontLong2_Left_Mid, PID_セリーヌ, cam_anim_pan_l_normal)\nフェードイン()\n\nキャラモーション再生(PID_セリーヌ, , EmoTalk2,,1)\n*\nキャラモーション再生(PID_セリーヌ, Shy, IdleNormal,,1)
MID_RELIANCE_B_#002	キャラカメラ(CharaCam_FrontLong2_Right_Mid, PID_オルテンシア, cam_anim_pan_r_normal)
MID_RELIANCE_B_#003	キャラモーション再生(PID_オルテンシア, , EmoJoy,,1)\n*\nキャラモーション再生(PID_オルテンシア, , WalkOut,, 1)\nパペット会話中断()\n一枚絵表示(Tex_Event_Effect_Black)\nウェイト(1.5)
MID_RELIANCE_B_#004	キャラモーション再生(PID_オルテンシア, Angry, IdleNormal)
MID_RELIANCE_B_#005	キャラモーション再生(PID_セリーヌ, Surprise, IdleNormal)
MID_RELIANCE_B_#006	*\nパペット会話中断()\nウェイト(0.7)\n一枚絵非表示()
MID_RELIANCE_B_#007	キャラカメラ(CharaCam_Front_Center2_Mid, PID_オルテンシア, cam_anim_zoom_in_fast)
MID_RELIANCE_B_#008	キャラカメラ(CharaCam_Side_Left2_Mid, PID_セリーヌ, cam_anim_zoom_in_normal)\n*\nキャラモーション再生(PID_セリーヌ, Normal, IdleNormal,,1)
MID_RELIANCE_B_#009	キャラカメラ(CharaCam_FrontLong2_Right_Mid, PID_オルテンシア, cam_anim_pan_r_normal)\nキャラモーション再生(PID_オルテンシア, , EmoDeny,,1)\n*\nキャラモーション再生(PID_オルテンシア, Shy, IdleNormal,,1)
MID_RELIANCE_B_#010	キャラカメラ(CharaCam_FrontLong2_Left_Mid, PID_セリーヌ, cam_anim_track3_r_normal)\nキャラモーション再生(PID_セリーヌ, , EmoRelax,,1)\n*\nキャラモーション再生(PID_セリーヌ, Smile, IdleNormal)
MID_RELIANCE_B_#011	キャラカメラ(CharaCam_Side_Right2_Mid, PID_オルテンシア, cam_anim_track_l_normal)\nキャラモーション再生(PID_オルテンシア, Angry, EmoAngry, 2, 1)\n*\nキャラモーション再生(PID_オルテンシア, Sad, IdleNormal)
MID_RELIANCE_B_#012	キャラカメラ(CharaCam_Side_Left2_Mid, PID_セリーヌ, cam_anim_track_r_normal)\nキャラモーション再生(PID_セリーヌ, , EmoNod,,1)\nキャラモーション再生(PID_セリーヌ, , IdleNormal, 1, 1)\n*\nキャラモーション再生(PID_セリーヌ, Normal, IdleNormal)\nキャラ配置調整(PID_セリーヌ, 0, 0, -0.7)\nキャラ表示切替(PID_セリーヌ, False)
MID_RELIANCE_B_#013	キャラカメラ(CharaCam_Side_Right2_Top, PID_オルテンシア, cam_anim_track_l_normal)\nキャラモーション再生(PID_オルテンシア, , EmoSad2,,1)
MID_RELIANCE_B_#014	*\nキャラモーション再生(PID_セリーヌ, , WalkIn2)\nキャラカメラ(CharaCam_FrontLong2_Right_Top, PID_オルテンシア, cam_anim_track_l_normal)\nキャラ表示切替(PID_セリーヌ, True)\n\nパペット会話中断()\n一枚絵表示(Tex_Event_Effect_Black)\nウェイト(1.5)
MID_RELIANCE_B_#015	キャラモーション再生(PID_オルテンシア, , IdleNormal)\nキャラモーション再生(PID_セリーヌ, Shy, IdleNormal)\nキャラ配置調整(PID_セリーヌ, 0, 0, 0.7)\n*\nパペット会話中断()\nウェイト(0.7)\n一枚絵非表示()
MID_RELIANCE_B_#016	キャラカメラ(CharaCam_Shoulder_Right_Mid, PID_セリーヌ, cam_anim_track3_r_normal)\nキャラモーション再生(PID_オルテンシア, Shy, EmoShy,, 0.3)\nキャラモーション再生(PID_オルテンシア, , IdleNormal, 2, 1)\n\nキャラモーション再生(PID_セリーヌ, , EmoSurprise,,1)\n*\nキャラモーション再生(PID_オルテンシア, Shy, IdleNormal,,1)
MID_RELIANCE_B_#017	キャラカメラ(CharaCam_FrontLong2_Left_Mid, PID_セリーヌ, cam_anim_track3_l_normal)\nキャラモーション再生(PID_セリーヌ, , EmoRelax,,1)\n*\nキャラ表示切替(PID_セリーヌ, False)\nキャラモーション再生(PID_セリーヌ, , IdleNormal)
MID_RELIANCE_B_#018	キャラカメラ(CharaCam_SideLong_Right2_Mid, PID_オルテンシア, cam_anim_track3_l_normal)\nキャラモーション再生(PID_オルテンシア, , EmoSad2,,1)
MID_RELIANCE_B_#019	キャラモーション再生(PID_オルテンシア, Sad, EmoAngry,,1)
MID_RELIANCE_B_#020	キャラモーション再生(PID_オルテンシア, Sad, RunOut,, 0.5)\nキャラ回転(PID_オルテンシア, -100, 1.4)\nキャラ視線(PID_オルテンシア, PID_デモ用_視線設定用, PID_デモ用_視線設定用)\n*\nキャラ表示切替(PID_オルテンシア, False)\nキャラ表示切替(PID_セリーヌ, True)
MID_RELIANCE_B_#021	キャラカメラ(CharaCam_SideLong_Right2_Mid, PID_セリーヌ, cam_anim_track3_r_normal)\nキャラモーション再生(PID_セリーヌ, , EmoRelax,,1)\n\nキャラ視線(PID_セリーヌ, PID_デモ用_視線設定用, PID_デモ用_視線設定用)\n*\nフェードアウト()
MID_RELIANCE_A_#001	キャラ配置(PID_セリーヌ, ME_IN_C,, Normal, IdleNormal)\nキャラ配置調整(PID_セリーヌ, 0, 0.05, 0)\nキャラ配置(PID_オルテンシア, YOU_IN_C,, Sad, IdleNormal, -80)\nキャラ表示切替(PID_セリーヌ, False)\n\n背景(Map_Event_Hub_Solanel_05_Day)\nライト(CharaLight_Hub_Day)\n\nキャラ視線(PID_セリーヌ, PID_オルテンシア, PID_オルテンシア)\n\nウェイト(0.1)\n\nキャラカメラ(CharaCam_SideLong_Right2_Mid, PID_オルテンシア, cam_anim_track3_l_normal)\nフェードイン()\n*\nキャラ表示切替(PID_セリーヌ, True)
MID_RELIANCE_A_#002	キャラカメラ(CharaCam_FrontLong2_Left_Mid, PID_セリーヌ, cam_anim_pan_l_normal)\nキャラモーション再生(PID_セリーヌ, , WalkIn2)\n\nキャラ視線(PID_オルテンシア, PID_セリーヌ, PID_セリーヌ, 1)\n*\nキャラモーション再生(PID_セリーヌ, Surprise, IdleNormal,,1)\nキャラ視線(PID_オルテンシア, PID_セリーヌ, PID_セリーヌ)
MID_RELIANCE_A_#003	キャラカメラ(CharaCam_FrontLong2_Right_Mid, PID_オルテンシア, cam_anim_track3_l_normal)\nキャラモーション再生(PID_オルテンシア, , TurnR,, 0.3)\nキャラ回転(PID_オルテンシア, 80, 1.3)
MID_RELIANCE_A_#004	*\nキャラモーション再生(PID_オルテンシア, Normal, IdleNormal)
MID_RELIANCE_A_#005	キャラカメラ(CharaCam_Side_Left3_Mid, PID_セリーヌ, cam_anim_zoom_in_slow)\n*\nキャラモーション再生(PID_セリーヌ, Shy, IdleNormal,,1)
MID_RELIANCE_A_#006	キャラカメラ(CharaCam_FrontLong2_Right_Mid, PID_オルテンシア, cam_anim_track3_r_normal)\nキャラモーション再生(PID_オルテンシア, , EmoTalk,,1)
MID_RELIANCE_A_#007	キャラモーション再生(PID_オルテンシア, Sad, EmoSad,,1)\n*\nキャラモーション再生(PID_オルテンシア, Normal, IdleNormal)
MID_RELIANCE_A_#008	キャラカメラ(CharaCam_SideLong_Left2_Mid, PID_セリーヌ, cam_anim_track3_r_normal)\nキャラモーション再生(PID_セリーヌ, , EmoRelax,,1)
MID_RELIANCE_A_#009	キャラモーション再生(PID_セリーヌ, , IdleNormal,,1)\n*\nキャラモーション再生(PID_セリーヌ, , WalkOut,, 1)\nパペット会話中断()\n一枚絵表示(Tex_Event_Effect_Black)\nウェイト(1.5)
MID_RELIANCE_A_#010	キャラモーション再生(PID_セリーヌ, , IdleNormal)\nキャラモーション再生(PID_オルテンシア, Shy)\n*\nパペット会話中断()\nウェイト(0.7)\n一枚絵非表示()
MID_RELIANCE_A_#011	キャラカメラ(CharaCam_SideLong_Right2_Mid, PID_オルテンシア, cam_anim_pan_r_normal)\nキャラモーション再生(PID_オルテンシア, , EmoSurprise,, 0.3)\n\n*\nキャラモーション再生(PID_オルテンシア, Smile, IdleNormal)\nキャラ視線(PID_オルテンシア, PID_セリーヌ, PID_セリーヌ)
MID_RELIANCE_A_#012	キャラカメラ(CharaCam_SideLong_Left2_Mid, PID_セリーヌ, cam_anim_track3_r_normal)\nキャラモーション再生(PID_セリーヌ, Smile, EmoTalk,,1)\nキャラ視線(PID_セリーヌ, PID_オルテンシア, PID_オルテンシア)
MID_RELIANCE_A_#013	キャラモーション再生(PID_セリーヌ, , EmoJoy,,1)
MID_RELIANCE_A_#014	キャラカメラ(CharaCam_FrontLong2_Left_Mid, PID_セリーヌ, cam_anim_track3_l_normal)\n*\nキャラモーション再生(PID_セリーヌ, Smile, IdleNormal)
MID_RELIANCE_A_#015	キャラカメラ(CharaCam_Side_Right2_Mid, PID_オルテンシア, cam_anim_track_l_normal)\n*\nキャラモーション再生(PID_オルテンシア, Sad, IdleNormal,,1)
MID_RELIANCE_A_#016	キャラカメラ(CharaCam_FrontLong2_Left_Mid, PID_セリーヌ, cam_anim_track3_l_normal)\nキャラモーション再生(PID_セリーヌ, , EmoTalk2,,1)
MID_RELIANCE_A_#017	*\nキャラモーション再生(PID_セリーヌ, Shy, IdleNormal)
MID_RELIANCE_A_#018	キャラカメラ(CharaCam_SideLong_Right2_Mid, PID_オルテンシア, cam_anim_track3_l_normal)\nキャラモーション再生(PID_オルテンシア, , EmoSad,,1)\nキャラ視線リセット(PID_オルテンシア)
MID_RELIANCE_A_#019	キャラモーション再生(PID_オルテンシア, Shy, EmoAngry,,1)\nキャラ視線(PID_オルテンシア, PID_セリーヌ, PID_セリーヌ)\n*\nキャラモーション再生(PID_オルテンシア, Sad, IdleNormal)
MID_RELIANCE_A_#020	キャラカメラ(CharaCam_Side_Left2_Mid, PID_セリーヌ, cam_anim_track_l_normal)\nキャラモーション再生(PID_セリーヌ, , EmoRelax,,1)\n\nキャラアニメーター切替(PID_オルテンシア, Unit/Anim/Demo/AOC_Demo_Hum2F)\n*\nキャラモーション再生(PID_セリーヌ, Smile, IdleNormal)
MID_RELIANCE_A_#021	キャラカメラ(CharaCam_Side_Right3_Top, PID_オルテンシア, cam_anim_track_r_normal)\nキャラモーション再生(PID_オルテンシア, , EmoShy,,1)\nキャラ視線リセット(PID_オルテンシア)\n*\nキャラモーション再生(PID_オルテンシア, Surprise, IdleNormal)\nキャラ視線(PID_オルテンシア, PID_セリーヌ, PID_セリーヌ)
MID_RELIANCE_A_#022	キャラカメラ(CharaCam_Side_Left3_Mid, PID_セリーヌ, cam_anim_track_l_normal)\nキャラモーション再生(PID_セリーヌ, , EmoTalk2,,1)\n\nキャラアニメーター切替(PID_オルテンシア, Unit/Anim/Demo/AOC_Demo_c351)
MID_RELIANCE_A_#023	*\nキャラモーション再生(PID_セリーヌ, Smile, IdleNormal)
MID_RELIANCE_A_#024	キャラカメラ(CharaCam_Side_Right2_Mid, PID_オルテンシア, cam_anim_zoom_in_slow)\n*\nキャラモーション再生(PID_オルテンシア, Smile, IdleNormal,,1)
MID_RELIANCE_A_#025	キャラカメラ(CharaCam_FrontLong2_Left_Mid, PID_セリーヌ, cam_anim_pan_l_normal)\nキャラモーション再生(PID_セリーヌ, , EmoTalk,,1)
MID_RELIANCE_A_#026	キャラモーション再生(PID_セリーヌ, , EmoRelax,,1)\n*\nキャラモーション再生(PID_セリーヌ, Smile, IdleNormal,,1)
MID_RELIANCE_A_#027	キャラカメラ(CharaCam_FrontLong2_Right_Mid, PID_オルテンシア, cam_anim_track3_l_normal)\nキャラモーション再生(PID_オルテンシア, , EmoRelax,,1)\n*\nキャラモーション再生(PID_オルテンシア, Normal, IdleNormal)
MID_RELIANCE_A_#028	キャラカメラ(CharaCam_Side_Left3_Mid, PID_セリーヌ, cam_anim_zoom_in_slow)\nキャラモーション再生(PID_セリーヌ, , EmoJoy,,1)\n*\nフェードアウト()
