MID_RELIANCE_C_#001	キャラ配置(PID_ディアマンド, ME_IN_C, [服装], Normal, IdleNormal, 0)\nキャラ配置(PID_ヴェイル, YOU_IN_C, [服装], Normal, IdleNormal, 0)\n\n背景(Map_Event_Hub_Solanel_01_Day)\nライト(CharaLight_Hub_Day, 0, 0, 0)\n\nキャラ視線(PID_ディアマンド, PID_ヴェイル, PID_ヴェイル)\nキャラ視線(PID_ヴェイル, PID_ディアマンド, PID_ディアマンド)\n\nウェイト(1)\n\nキャラカメラ(CharaCam_FrontLong2_Right_Top, PID_ヴェイル, cam_anim_track2_r_normal)\n\nフェードイン()
MID_RELIANCE_C_#002	キャラカメラ(CharaCam_Side_Left2_Mid, PID_ディアマンド, cam_anim_track_r_normal)
MID_RELIANCE_C_#003	キャラモーション再生(PID_ヴェイル, Sad, EmoSad2,, 0.3)\n\nキャラカメラ(CharaCam_Side_Right2_Mid, PID_ヴェイル, cam_anim_track_l_normal)
MID_RELIANCE_C_#004	キャラモーション再生(PID_ディアマンド, Normal, EmoDeny)\nキャラモーション再生(PID_ヴェイル, Sad, IdleNormal)\n\nキャラカメラ(CharaCam_Front_Center2_Mid, PID_ディアマンド, cam_anim_pan_d_normal)
MID_RELIANCE_C_#005	キャラモーション再生(PID_ディアマンド, Normal, IdleNormal)\n\nキャラカメラ(CharaCam_Front_Center_Top, PID_ヴェイル, cam_anim_pan_u_normal)
MID_RELIANCE_C_#006	キャラカメラ(CharaCam_Side_Left3_Mid, PID_ディアマンド, cam_anim_pan_d_slow)
MID_RELIANCE_C_#007	キャラモーション再生(PID_ディアマンド, Die, EmoThink,, 0.3)\n\n*\n\nキャラカメラ(CharaCam_Shoulder_Left_Bot, PID_ヴェイル, cam_anim_track2_l_normal)\n\nパペット会話中断()\n\nウェイト(1.5)
MID_RELIANCE_C_#008	キャラモーション再生(PID_ディアマンド, Relax, IdleNormal,, 1)
MID_RELIANCE_C_#009	キャラモーション再生(PID_ヴェイル, Surprise)\n\nキャラカメラ(CharaCam_Side_Right2_Mid, PID_ヴェイル, cam_anim_track_l_normal)
MID_RELIANCE_C_#010	キャラカメラ(CharaCam_Side_Left2_Mid, PID_ディアマンド, cam_anim_track_r_slow)
MID_RELIANCE_C_#011	キャラモーション再生(PID_ディアマンド, Relax, EmoTalk, 2, 0.3)
MID_RELIANCE_C_#012	キャラモーション再生(PID_ディアマンド, Smile)
MID_RELIANCE_C_#013	キャラモーション再生(PID_ヴェイル, Smile, EmoNod,, 0.3)\nキャラモーション再生(PID_ディアマンド, Smile, IdleNormal)\n\nキャラカメラ(CharaCam_Front_Center_Top, PID_ヴェイル, cam_anim_pan_u_normal)\n\n*\n\nキャラモーション再生(PID_ヴェイル, Smile, IdleNormal,, 1)\n\nパペット会話中断()\n\nフェードアウト()
MID_RELIANCE_C_#014	
MID_RELIANCE_C_#015	背景(Map_Event_M008_01)\nライト(CharaLight_M008, 0, 0, 0)\n\nウェイト(1.5)\n\nキャラモーション再生(PID_ヴェイル, Sad, EmoSad,, 0.3)\n\nキャラカメラ(CharaCam_Front_Center_Top, PID_ヴェイル, cam_anim_zoom_out_slow)\n\nフェードイン()
MID_RELIANCE_C_#016	
MID_RELIANCE_C_#017	キャラモーション再生(PID_ディアマンド, Normal)\nキャラモーション再生(PID_ヴェイル, Sad, IdleNormal,, 1)\n\nキャラカメラ(CharaCam_Shoulder_Left_Mid, PID_ヴェイル, cam_anim_pan_u_normal)
MID_RELIANCE_C_#018	キャラモーション再生(PID_ディアマンド, Relax)\n\nキャラカメラ(CharaCam_Side_Left2_Mid, PID_ディアマンド, cam_anim_track_r_slow)
MID_RELIANCE_C_#019	キャラモーション再生(PID_ディアマンド, Smile)\nキャラモーション再生(PID_ディアマンド, Smile, EmoRelax, 2, 0.3)
MID_RELIANCE_C_#020	キャラモーション再生(PID_ヴェイル, Sad, EmoSad2,, 0.3)\nキャラモーション再生(PID_ディアマンド, Smile, IdleNormal)\n\nキャラカメラ(CharaCam_Side_Right2_Mid, PID_ヴェイル, cam_anim_track_l_normal)
MID_RELIANCE_C_#021	キャラモーション再生(PID_ディアマンド, Relax)\nキャラモーション再生(PID_ヴェイル, Sad, IdleNormal)\n\nキャラカメラ(CharaCam_Front_Center2_Mid, PID_ディアマンド, cam_anim_pan_d_slow)
MID_RELIANCE_C_#022	キャラモーション再生(PID_ディアマンド, Relax, EmoTalk, 2, 0.3)
MID_RELIANCE_C_#023	キャラモーション再生(PID_ディアマンド, Smile)
MID_RELIANCE_C_#024	キャラモーション再生(PID_ヴェイル, Surprise)\nキャラモーション再生(PID_ヴェイル, Smile, EmoPray, 2.5, 0.3)\nキャラモーション再生(PID_ディアマンド, Smile, IdleNormal)\n\nキャラカメラ(CharaCam_Front_Center_Top, PID_ヴェイル, cam_anim_zoom_out_normal)\n\n*\n\nフェードアウト()
MID_RELIANCE_B_#001	キャラ配置(PID_ディアマンド, ME_IN_C, [服装], Normal, IdleNormal, 0)\nキャラ配置(PID_ヴェイル, YOU_IN_C, [服装], Normal, IdleNormal, 0)\n\n背景(Map_Event_Hub_Solanel_01_Day)\nライト(CharaLight_Hub_Day, 0, 0, 0)\n\nキャラ視線(PID_ディアマンド, PID_ヴェイル, PID_ヴェイル)\nキャラ視線(PID_ヴェイル, PID_ディアマンド, PID_ディアマンド)\n\nウェイト(1)\n\nキャラカメラ(CharaCam_FrontLong2_Right_Top, PID_ヴェイル, cam_anim_track2_r_normal)\n\nフェードイン()
MID_RELIANCE_B_#002	キャラカメラ(CharaCam_Side_Left3_Mid, PID_ディアマンド, cam_anim_pan_d_slow)
MID_RELIANCE_B_#003	キャラモーション再生(PID_ディアマンド, Normal, EmoTalk, 1.8, 0.3)
MID_RELIANCE_B_#004	キャラモーション再生(PID_ヴェイル, Smile)\nキャラモーション再生(PID_ディアマンド, Normal, IdleNormal)\n\nキャラカメラ(CharaCam_Front_Center_Top, PID_ヴェイル, cam_anim_pan_u_slow)
MID_RELIANCE_B_#005	キャラモーション再生(PID_ヴェイル, Normal)
MID_RELIANCE_B_#006	キャラカメラ(CharaCam_Side_Left2_Mid, PID_ディアマンド, cam_anim_track_r_normal)
MID_RELIANCE_B_#007	キャラモーション再生(PID_ヴェイル, Normal, EmoNod,, 0.3)\n\nキャラカメラ(CharaCam_Side_Right2_Mid, PID_ヴェイル, cam_anim_track_l_normal)
MID_RELIANCE_B_#008	キャラモーション再生(PID_ヴェイル, Sad, IdleNormal)\n\nキャラカメラ(CharaCam_Front_Center_Top, PID_ディアマンド, cam_anim_pan_u_normal)
MID_RELIANCE_B_#009	キャラモーション再生(PID_ヴェイル, Surprise)\nキャラモーション再生(PID_ヴェイル, Sad, EmoSad2, 1, 0.3)\n\nキャラカメラ(CharaCam_Front_Center2_Mid, PID_ヴェイル, cam_anim_zoom_in_normal)
MID_RELIANCE_B_#010	キャラモーション再生(PID_ヴェイル, Sad, IdleNormal)\n\nキャラカメラ(CharaCam_Side_Left2_Mid, PID_ディアマンド, cam_anim_track_r_normal)
MID_RELIANCE_B_#011	キャラカメラ(CharaCam_Side_Right2_Mid, PID_ヴェイル, cam_anim_track_l_normal)
MID_RELIANCE_B_#012	キャラカメラ(CharaCam_Shoulder_Left_Bot, PID_ヴェイル, cam_anim_track2_l_normal)
MID_RELIANCE_B_#013	キャラモーション再生(PID_ディアマンド, Sad, EmoDeny2,, 0.3)
MID_RELIANCE_B_#014	キャラモーション再生(PID_ヴェイル, Smile)\nキャラモーション再生(PID_ディアマンド, Sad, IdleNormal)\n\nキャラカメラ(CharaCam_Front_Center_Top, PID_ヴェイル, cam_anim_pan_u_normal)
MID_RELIANCE_B_#015	キャラモーション再生(PID_ディアマンド, Normal, EmoTalk,, 0.3)\n\nキャラカメラ(CharaCam_Side_Left2_Mid, PID_ディアマンド, cam_anim_track_r_normal)
MID_RELIANCE_B_#016	キャラモーション再生(PID_ディアマンド, Normal, IdleNormal)\n\nキャラカメラ(CharaCam_Side_Right2_Mid, PID_ヴェイル, cam_anim_track_l_slow)
MID_RELIANCE_B_#017	キャラモーション再生(PID_ヴェイル, Smile, EmoTalk2, 2.3, 0.3)
MID_RELIANCE_B_#018	キャラモーション再生(PID_ディアマンド, Relax)\nキャラモーション再生(PID_ヴェイル, Smile, IdleNormal)\n\nキャラカメラ(CharaCam_Side_Left3_Mid, PID_ディアマンド, cam_anim_pan_d_slow)
MID_RELIANCE_B_#019	キャラモーション再生(PID_ディアマンド, Relax, EmoNod,, 0.3)
MID_RELIANCE_B_#020	キャラモーション再生(PID_ヴェイル, Smile, EmoTalk, 1.2, 0.3)\nキャラモーション再生(PID_ディアマンド, Relax, IdleNormal)\n\nキャラカメラ(CharaCam_Front_Center_Top, PID_ヴェイル, cam_anim_zoom_out_normal)\n\n*\n\nフェードアウト()
MID_RELIANCE_A_#001	キャラ配置(PID_ディアマンド, YOU_IN_C, [服装], Normal, IdleNormal, 0)\nキャラ配置(PID_ヴェイル, ME_IN_C, [服装], Normal, IdleNormal, 0)\n\n背景(Map_Event_Hub_Solanel_15_Day)\nライト(CharaLight_Hub_Day, 0, 0, 0)\n\nキャラ視線(PID_ディアマンド, PID_ヴェイル, PID_ヴェイル)\nキャラ視線(PID_ヴェイル, PID_ディアマンド, PID_ディアマンド)\n\nキャラモーション再生(PID_ディアマンド, Sad)\n\nウェイト(1)\n\nキャラカメラ(CharaCam_Front_Center_Top, PID_ディアマンド, cam_anim_pan_u_normal)\n\nフェードイン()
MID_RELIANCE_A_#002	キャラモーション再生(PID_ヴェイル, Sad, EmoSad2)\n\nキャラカメラ(CharaCam_FrontLong2_Right_Top, PID_ヴェイル, cam_anim_track2_r_normal)
MID_RELIANCE_A_#003	キャラモーション再生(PID_ディアマンド, Die)\nキャラモーション再生(PID_ヴェイル, Sad, IdleNormal)\n\nキャラカメラ(CharaCam_Side_Left2_Mid, PID_ディアマンド, cam_anim_track_r_slow)
MID_RELIANCE_A_#004	キャラモーション再生(PID_ディアマンド, Sad)
MID_RELIANCE_A_#005	キャラカメラ(CharaCam_Side_Right2_Mid, PID_ヴェイル, cam_anim_track_l_slow)
MID_RELIANCE_A_#006	
MID_RELIANCE_A_#007	キャラモーション再生(PID_ディアマンド, Sad, EmoDeny2)\n\nキャラカメラ(CharaCam_Side_Left3_Mid, PID_ディアマンド, cam_anim_pan_d_normal)
MID_RELIANCE_A_#008	キャラモーション再生(PID_ディアマンド, Sad, IdleNormal)\n\nキャラカメラ(CharaCam_Front_Center_Top, PID_ヴェイル, cam_anim_zoom_out_slow)
MID_RELIANCE_A_#009	キャラモーション再生(PID_ヴェイル, Die, EmoSad,, 0.3)
MID_RELIANCE_A_#010	キャラモーション再生(PID_ヴェイル, Die, IdleNormal)\n\nキャラカメラ(CharaCam_Side_Left2_Top, PID_ディアマンド, cam_anim_zoom_in_slow)
MID_RELIANCE_A_#011	キャラモーション再生(PID_ディアマンド, Relax)
MID_RELIANCE_A_#012	キャラモーション再生(PID_ヴェイル, Surprise)\nキャラモーション再生(PID_ディアマンド, Relax, IdleNormal)\n\nキャラカメラ(CharaCam_Front_Center2_Mid, PID_ヴェイル, cam_anim_zoom_in_normal)
MID_RELIANCE_A_#013	キャラモーション再生(PID_ディアマンド, Relax, EmoTalk)\nキャラモーション再生(PID_ディアマンド, Smile,, 4.4)\n\nキャラカメラ(CharaCam_Shoulder_Left_Bot, PID_ヴェイル, cam_anim_track2_l_normal)
MID_RELIANCE_A_#014	キャラモーション再生(PID_ヴェイル, Sad)\nキャラモーション再生(PID_ディアマンド, Smile, IdleNormal)\n\nキャラカメラ(CharaCam_Side_Right3_Bot, PID_ヴェイル, cam_anim_pan_d_normal)
MID_RELIANCE_A_#015	キャラモーション再生(PID_ディアマンド, Smile, EmoRelax, 4, 0.3)\n\nキャラカメラ(CharaCam_Side_Left2_Mid, PID_ディアマンド, cam_anim_track_r_normal)
MID_RELIANCE_A_#016	キャラモーション再生(PID_ヴェイル, Smile)\nキャラモーション再生(PID_ヴェイル, Smile, EmoTalk, 1.6, 0.3)\nキャラモーション再生(PID_ディアマンド, Smile, IdleNormal)\n\nキャラカメラ(CharaCam_Side_Right2_Mid, PID_ヴェイル, cam_anim_track_l_normal)
MID_RELIANCE_A_#017	キャラモーション再生(PID_ディアマンド, Smile, EmoNod)\nキャラモーション再生(PID_ヴェイル, Smile, IdleNormal)\n\nキャラカメラ(CharaCam_Side_Left3_Mid, PID_ディアマンド, cam_anim_pan_d_normal)
MID_RELIANCE_A_#018	キャラモーション再生(PID_ヴェイル, Smile, EmoThink,, 0.3)\nキャラモーション再生(PID_ディアマンド, Smile, IdleNormal)\n\nキャラカメラ(CharaCam_Side_Right2_Mid, PID_ヴェイル, cam_anim_pan_l_normal)
MID_RELIANCE_A_#019	キャラモーション再生(PID_ディアマンド, Smile, EmoProud)\nキャラモーション再生(PID_ヴェイル, Smile, IdleNormal)\n\nキャラカメラ(CharaCam_Side_Left2_Mid, PID_ディアマンド, cam_anim_pan_r_normal)
MID_RELIANCE_A_#020	キャラモーション再生(PID_ヴェイル, Smile, EmoJoy, 4, 0.3)\nキャラモーション再生(PID_ディアマンド, Smile, IdleNormal)\n\nキャラカメラ(CharaCam_Front_Center_Top, PID_ヴェイル, cam_anim_zoom_out_normal)\n\n*\n\nフェードアウト()
