MID_RELIANCE_C_#001	キャラ配置(PID_ディアマンド, ME_IN_C, [服装], Normal, IdleNormal, 0)\nキャラ配置(PID_アンバー, YOU_IN_C, [服装], Normal, IdleNormal, 0)\nキャラ配置(PID_デモ用_視線設定用, ME_IN_BC, [服装], Normal, IdleNormal, 0)\n\nキャラ配置調整(PID_デモ用_視線設定用, 0, -1, 0, 0)\n\n背景(Map_Event_Hub_Solanel_18_Day)\nライト(CharaLight_Hub_Day, 0, 0, 0)\n\nキャラ視線(PID_ディアマンド, PID_アンバー, PID_アンバー)\nキャラ視線(PID_アンバー, PID_ディアマンド, PID_ディアマンド)\n\nキャラモーション再生(PID_アンバー, Normal, EmoGive)\n\nウェイト(0.1)\n\nキャラカメラ(CharaCam_Shoulder_Right_Top, PID_ディアマンド, cam_anim_track2_r_normal)\n\nフェードイン()
MID_RELIANCE_C_#002	キャラモーション再生(PID_アンバー, Normal, EmoTalk2, 2.8, 0.3)
MID_RELIANCE_C_#003	キャラモーション再生(PID_ディアマンド, Normal, EmoNod,, 0.3)\nキャラモーション再生(PID_アンバー, Normal, IdleNormal)\n\nキャラカメラ(CharaCam_Side_Left3_Mid, PID_ディアマンド, cam_anim_pan_d_normal)
MID_RELIANCE_C_#004	キャラモーション再生(PID_アンバー, Strike,, 1.8)\nキャラモーション再生(PID_ディアマンド, Normal, IdleNormal)\n\nキャラカメラ(CharaCam_Front_Center_Top, PID_アンバー, cam_anim_fix)\n\n*\n\nキャラモーション再生(PID_アンバー, Strike, EmoGive,, 0.3)\n\nキャラ視線(PID_アンバー, PID_デモ用_視線設定用, PID_デモ用_視線設定用)\n\nウェイト(0.7)
MID_RELIANCE_C_#005	キャラモーション再生(PID_アンバー, Surprise, IdleNormal,, 1)\n\nキャラカメラ(CharaCam_Front_Center_Top, PID_アンバー, cam_anim_quake_w_once)
MID_RELIANCE_C_#006	キャラモーション再生(PID_ディアマンド, Sad)\n\nキャラ視線(PID_アンバー, PID_ディアマンド, PID_ディアマンド)\n\nキャラカメラ(CharaCam_Side_Left2_Mid, PID_ディアマンド, cam_anim_track_r_normal)
MID_RELIANCE_C_#007	キャラモーション再生(PID_アンバー, Pain, EmoThink)\n\nキャラカメラ(CharaCam_Side_Right2_Top, PID_アンバー, cam_anim_zoom_in_slow)
MID_RELIANCE_C_#008	キャラモーション再生(PID_アンバー, Sad)
MID_RELIANCE_C_#009	キャラモーション再生(PID_ディアマンド, Surprise)\nキャラモーション再生(PID_アンバー, Sad, IdleNormal)\n\nキャラカメラ(CharaCam_Front_Center2_Mid, PID_ディアマンド, cam_anim_pan_d_normal)
MID_RELIANCE_C_#010	キャラカメラ(CharaCam_FrontLong2_Right_Mid, PID_アンバー, cam_anim_track_l_slow)
MID_RELIANCE_C_#011	キャラモーション再生(PID_アンバー, Sad, EmoSad2, 1.2, 0.3)
MID_RELIANCE_C_#012	キャラモーション再生(PID_アンバー, Sad, EmoNod,, 1)\n\nキャラカメラ(CharaCam_Front_Center2_Mid, PID_アンバー, cam_anim_zoom_in_slow)
MID_RELIANCE_C_#013	キャラモーション再生(PID_アンバー, Sad, IdleNormal,, 1)\nキャラモーション再生(PID_アンバー, Pain, EmoThink, 5.2, 0.3)
MID_RELIANCE_C_#014	キャラモーション再生(PID_アンバー, Die)
MID_RELIANCE_C_#015	キャラモーション再生(PID_ディアマンド, Sad)\nキャラモーション再生(PID_アンバー, Die, IdleNormal)\n\nキャラカメラ(CharaCam_Side_Left3_Mid, PID_ディアマンド, cam_anim_pan_d_normal)
MID_RELIANCE_C_#016	キャラモーション再生(PID_アンバー, Sad)\n\nキャラカメラ(CharaCam_Front_Center_Top, PID_アンバー, cam_anim_zoom_out_normal)
MID_RELIANCE_C_#017	キャラモーション再生(PID_ディアマンド, Normal)\n\nキャラカメラ(CharaCam_Side_Left2_Mid, PID_ディアマンド, cam_anim_track_r_normal)
MID_RELIANCE_C_#018	キャラモーション再生(PID_アンバー, Surprise)\nキャラモーション再生(PID_ディアマンド, Normal, IdleNormal)\n\nキャラカメラ(CharaCam_Side_Right2_Mid, PID_アンバー, cam_anim_track_l_normal)
MID_RELIANCE_C_#019	キャラモーション再生(PID_ディアマンド, Shy)\nキャラモーション再生(PID_ディアマンド, Relax,, 3.3)\n\nキャラカメラ(CharaCam_Front_Center2_Mid, PID_ディアマンド, cam_anim_pan_d_normal)
MID_RELIANCE_C_#020	キャラモーション再生(PID_アンバー, Sad, EmoNod)\nキャラモーション再生(PID_ディアマンド, Relax, IdleNormal)\n\nキャラカメラ(CharaCam_Front_Center_Top, PID_アンバー, cam_anim_pan_u_normal)\n\n*\n\nフェードアウト()
MID_RELIANCE_B_#001	キャラ配置(PID_ディアマンド, YOU_IN_C, [服装], Normal, IdleNormal, 0)\nキャラ配置(PID_アンバー, ME_IN_C, [服装], Normal, IdleNormal, 0)\n\n背景(Map_Event_Hub_Solanel_01_Day)\nライト(CharaLight_Hub_Day, 0, 0, 0)\n\nキャラ視線(PID_ディアマンド, PID_アンバー, PID_アンバー)\nキャラ視線(PID_アンバー, PID_ディアマンド, PID_ディアマンド)\n\nウェイト(1)\n\nキャラカメラ(CharaCam_FrontLong2_Left_Mid, PID_ディアマンド, cam_anim_zoom_in_normal)\n\nフェードイン()
MID_RELIANCE_B_#002	キャラモーション再生(PID_アンバー, Strike)\nキャラモーション再生(PID_ディアマンド, Normal, IdleNormal)\n\nキャラカメラ(CharaCam_Side_Right2_Mid, PID_アンバー, cam_anim_track_l_normal)
MID_RELIANCE_B_#003	キャラモーション再生(PID_ディアマンド, Normal, EmoShy)\n\nキャラカメラ(CharaCam_Side_Left2_Mid, PID_ディアマンド, cam_anim_track_r_normal)
MID_RELIANCE_B_#004	キャラモーション再生(PID_アンバー, Smile, EmoSad,, 0.3)\nキャラモーション再生(PID_アンバー, Relax,, 3.5)\nキャラモーション再生(PID_ディアマンド, Normal, IdleNormal)\n\nキャラカメラ(CharaCam_Front_Center_Top, PID_アンバー, cam_anim_zoom_out_normal)
MID_RELIANCE_B_#005	キャラモーション再生(PID_ディアマンド, Smile)\nキャラモーション再生(PID_ディアマンド, Smile, EmoRelax, 4.5, 0.3)\nキャラモーション再生(PID_アンバー, Relax, IdleNormal)\n\nキャラカメラ(CharaCam_Front_Center2_Mid, PID_ディアマンド, cam_anim_pan_d_normal)
MID_RELIANCE_B_#006	キャラモーション再生(PID_ディアマンド, Relax, IdleNormal,, 1)\n\nキャラカメラ(CharaCam_Shoulder_Left_Top, PID_アンバー, cam_anim_pan_u_slow)
MID_RELIANCE_B_#007	キャラモーション再生(PID_ディアマンド, Relax, EmoTalk, 1.5, 0.3)
MID_RELIANCE_B_#008	キャラモーション再生(PID_アンバー, Normal, EmoNod,, 0.3)\nキャラモーション再生(PID_ディアマンド, Relax, IdleNormal)\n\nキャラカメラ(CharaCam_Side_Right3_Mid, PID_アンバー, cam_anim_pan_d_slow)
MID_RELIANCE_B_#009	キャラモーション再生(PID_アンバー, Normal, IdleNormal,, 1)
MID_RELIANCE_B_#010	キャラモーション再生(PID_アンバー, Relax)\n\nキャラカメラ(CharaCam_Shoulder_Right_Top, PID_ディアマンド, cam_anim_track2_r_normal)
MID_RELIANCE_B_#011	キャラカメラ(CharaCam_Side_Left3_Mid, PID_ディアマンド, cam_anim_pan_d_slow)
MID_RELIANCE_B_#012	キャラモーション再生(PID_ディアマンド, Smile)
MID_RELIANCE_B_#013	キャラモーション再生(PID_アンバー, Sad, EmoThink)\nキャラモーション再生(PID_アンバー, Smile,, 2.8)\n\nキャラカメラ(CharaCam_Front_Center_Top, PID_アンバー, cam_anim_pan_u_slow)
MID_RELIANCE_B_#014	キャラモーション再生(PID_アンバー, Normal, IdleNormal,, 1)
MID_RELIANCE_B_#015	キャラモーション再生(PID_ディアマンド, Normal, EmoThink)\n\nキャラカメラ(CharaCam_Side_Left2_Mid, PID_ディアマンド, cam_anim_track_r_slow)
MID_RELIANCE_B_#016	
MID_RELIANCE_B_#017	
MID_RELIANCE_B_#018	キャラモーション再生(PID_アンバー, Sad)\nキャラモーション再生(PID_ディアマンド, Normal, IdleNormal)\n\nキャラカメラ(CharaCam_Side_Right2_Mid, PID_アンバー, cam_anim_track_l_slow)
MID_RELIANCE_B_#019	キャラモーション再生(PID_アンバー, Sad, EmoSad,, 0.3)\nキャラモーション再生(PID_アンバー, Normal,, 3.5)
MID_RELIANCE_B_#020	キャラモーション再生(PID_ディアマンド, Normal, EmoNod)\nキャラモーション再生(PID_ディアマンド, Normal, IdleNormal, 2, 1)\nキャラモーション再生(PID_アンバー, Normal, IdleNormal)\n\nキャラカメラ(CharaCam_Front_Center2_Mid, PID_ディアマンド, cam_anim_pan_d_normal)\n\n*\n\nフェードアウト()
MID_RELIANCE_A_#001	キャラ配置(PID_ディアマンド, YOU_IN_C, [服装], Normal, IdleNormal, 0)\nキャラ配置(PID_アンバー, ME_IN_C, [服装], Normal, IdleNormal, 0)\n\n背景(Map_Event_Hub_Solanel_01_Day)\nライト(CharaLight_Hub_Day, 0, 0, 0)\n\nキャラ視線(PID_ディアマンド, PID_アンバー, PID_アンバー)\nキャラ視線(PID_アンバー, PID_ディアマンド, PID_ディアマンド)\n\nウェイト(1)\n\nキャラカメラ(CharaCam_FrontLong2_Left_Mid, PID_ディアマンド, cam_anim_zoom_in_normal)\n\nフェードイン()
MID_RELIANCE_A_#002	キャラカメラ(CharaCam_Side_Right2_Mid, PID_アンバー, cam_anim_track_l_normal)
MID_RELIANCE_A_#003	キャラカメラ(CharaCam_Side_Left2_Mid, PID_ディアマンド, cam_anim_track_r_normal)
MID_RELIANCE_A_#004	キャラモーション再生(PID_アンバー, Relax, EmoTalk, 3.5, 0.3)\n\nキャラカメラ(CharaCam_Front_Center_Mid, PID_アンバー, cam_anim_zoom_out_slow)
MID_RELIANCE_A_#005	キャラモーション再生(PID_ディアマンド, Surprise)\nキャラモーション再生(PID_アンバー, Relax, IdleNormal)\n\nキャラカメラ(CharaCam_Front_Center_Top, PID_ディアマンド, cam_anim_pan_u_normal)
MID_RELIANCE_A_#006	キャラモーション再生(PID_アンバー, Relax, EmoNod)\n\nキャラカメラ(CharaCam_Side_Right2_Mid, PID_アンバー, cam_anim_track_l_normal)
MID_RELIANCE_A_#007	キャラモーション再生(PID_ディアマンド, Normal)\nキャラモーション再生(PID_アンバー, Relax, IdleNormal)\n\nキャラカメラ(CharaCam_Side_Left2_Mid, PID_ディアマンド, cam_anim_track_r_normal)
MID_RELIANCE_A_#008	キャラモーション再生(PID_アンバー, Normal)\n\nキャラカメラ(CharaCam_Front_Center_Top, PID_アンバー, cam_anim_pan_u_slow)
MID_RELIANCE_A_#009	
MID_RELIANCE_A_#010	キャラカメラ(CharaCam_Side_Left3_Mid, PID_ディアマンド, cam_anim_pan_d_normal)
MID_RELIANCE_A_#011	キャラモーション再生(PID_アンバー, Sad, EmoSad,, 0.3)\n\nキャラカメラ(CharaCam_Side_Right2_Mid, PID_アンバー, cam_anim_track_l_slow)
MID_RELIANCE_A_#012	キャラモーション再生(PID_アンバー, Normal, IdleNormal,, 1.5)
MID_RELIANCE_A_#013	キャラカメラ(CharaCam_Shoulder_Right_Top, PID_ディアマンド, cam_anim_track2_r_normal)
MID_RELIANCE_A_#014	キャラモーション再生(PID_アンバー, Relax, EmoTalk2, 1.3, 0.3)
MID_RELIANCE_A_#015	キャラモーション再生(PID_ディアマンド, Surprise)\nキャラモーション再生(PID_アンバー, Relax, IdleNormal)\n\nキャラカメラ(CharaCam_Front_Center2_Mid, PID_ディアマンド, cam_anim_zoom_in_fast)
MID_RELIANCE_A_#016	キャラモーション再生(PID_アンバー, Relax, EmoNod)\n\nキャラカメラ(CharaCam_Side_Right2_Mid, PID_アンバー, cam_anim_track_l_normal)
MID_RELIANCE_A_#017	キャラモーション再生(PID_ディアマンド, Sad)\nキャラモーション再生(PID_アンバー, Relax, IdleNormal)\n\nキャラカメラ(CharaCam_Side_Left2_Mid, PID_ディアマンド, cam_anim_track_r_normal)
MID_RELIANCE_A_#018	キャラモーション再生(PID_アンバー, Sad)\n\nキャラカメラ(CharaCam_Side_Right3_Mid, PID_アンバー, cam_anim_pan_d_normal)
MID_RELIANCE_A_#019	キャラモーション再生(PID_ディアマンド, Sad, EmoDeny2)\n\nキャラカメラ(CharaCam_Front_Center_Top, PID_ディアマンド, cam_anim_zoom_out_normal)
MID_RELIANCE_A_#020	キャラモーション再生(PID_アンバー, Sad, EmoThink, 2, 0.3)\nキャラモーション再生(PID_ディアマンド, Sad, IdleNormal)\n\nキャラカメラ(CharaCam_Side_Right2_Top, PID_アンバー, cam_anim_zoom_in_slow)
MID_RELIANCE_A_#021	キャラモーション再生(PID_アンバー, Relax)\n
MID_RELIANCE_A_#022	キャラモーション再生(PID_ディアマンド, Surprise)\nキャラモーション再生(PID_アンバー, Smile, IdleNormal)\n\nキャラカメラ(CharaCam_Side_Left3_Mid, PID_ディアマンド, cam_anim_pan_d_normal)
MID_RELIANCE_A_#023	キャラモーション再生(PID_アンバー, Strike)\nキャラモーション再生(PID_アンバー, Strike, EmoTalk2, 3.3, 0.3)\n\nキャラカメラ(CharaCam_Shoulder_Right_Top, PID_ディアマンド, cam_anim_track2_r_normal)
MID_RELIANCE_A_#024	キャラモーション再生(PID_ディアマンド, Sad)\nキャラモーション再生(PID_アンバー, Strike, IdleNormal)\n\nキャラカメラ(CharaCam_Front_Center2_Mid, PID_ディアマンド, cam_anim_zoom_in_normal)
MID_RELIANCE_A_#025	キャラカメラ(CharaCam_Front_Center2_Mid, PID_アンバー, cam_anim_zoom_in_normal)
MID_RELIANCE_A_#026	キャラモーション再生(PID_ディアマンド, Normal, EmoTalk)\n\nキャラカメラ(CharaCam_FrontLong2_Left_Mid, PID_ディアマンド, cam_anim_zoom_in_normal)
MID_RELIANCE_A_#027	キャラモーション再生(PID_アンバー, Surprise)\nキャラモーション再生(PID_ディアマンド, Normal, IdleNormal)\n\nキャラカメラ(CharaCam_Side_Right2_Top, PID_アンバー, cam_anim_zoom_in_normal)
MID_RELIANCE_A_#028	キャラモーション再生(PID_ディアマンド, Smile)\n\nキャラカメラ(CharaCam_Front_Center2_Mid, PID_ディアマンド, cam_anim_pan_d_slow)
MID_RELIANCE_A_#029	キャラモーション再生(PID_ディアマンド, Smile, EmoRelax,, 0.3)
MID_RELIANCE_A_#030	キャラモーション再生(PID_アンバー, Smile)\nキャラモーション再生(PID_アンバー, Smile, EmoTalk, 2.5, 0.3)\nキャラモーション再生(PID_ディアマンド, Smile, IdleNormal)\n\nキャラカメラ(CharaCam_Front_Center2_Mid, PID_アンバー, cam_anim_zoom_in_normal)\n\n*\n\nフェードアウト()
