MID_RELIANCE_C_#001	キャラ配置(PID_エーティエ, ME_IN_C,, Normal, IdleNormal, 60)\nキャラ配置(PID_フォガート, YOU_IN_C,, Sad, EmoThinkLoop, -60)\n\n背景(Map_Event_Hub_Solanel_01_Day)\nライト(CharaLight_M001)\n\nキャラ視線(PID_エーティエ, PID_フォガート, PID_フォガート)\n\nウェイト(0.3)\n\nキャラカメラ(CharaCam_Side_Right2_Bot, PID_フォガート, cam_anim_track_r_normal)\nフェードイン()\n\n*\n\nキャラモーション再生(PID_エーティエ, , WalkIn2)\nウェイト(0.1)
MID_RELIANCE_C_#002	キャラカメラ(CharaCam_FrontLong2_Left_Top, PID_エーティエ, cam_anim_track_r_normal)\nキャラ回転(PID_エーティエ, -60, 1.3, 0.8)\n\nキャラ視線(PID_フォガート, PID_エーティエ, PID_エーティエ, 1)\n*\nキャラ視線(PID_フォガート, PID_エーティエ, PID_エーティエ)\nウェイト(0.1)
MID_RELIANCE_C_#003	キャラカメラ(CharaCam_SideLong_Right2_Mid, PID_フォガート, cam_anim_track3_l_normal)\nキャラモーション再生(PID_フォガート, , TurnR,, 0.7)\nキャラ回転(PID_フォガート, 60, 1.3)
MID_RELIANCE_C_#004	キャラモーション再生(PID_フォガート, Relax, EmoJoy,,1)\nキャラモーション再生(PID_フォガート, Sad,,3)\n*\nキャラモーション再生(PID_フォガート, Sad, IdleNormal)
MID_RELIANCE_C_#005	キャラカメラ(CharaCam_Side_Left2_Mid, PID_エーティエ, cam_anim_track_r_normal)\nキャラモーション再生(PID_エーティエ, , EmoThinkIn,,1)\nキャラ視線(PID_フォガート, PID_エーティエ, PID_エーティエ)
MID_RELIANCE_C_#006	キャラカメラ(CharaCam_Front_Center_Mid, PID_フォガート, cam_anim_track_r_normal)
MID_RELIANCE_C_#007	キャラモーション再生(PID_フォガート, , EmoSad,,1)\n*\nキャラモーション再生(PID_フォガート, Normal, IdleNormal)\nキャラ視線(PID_フォガート, PID_エーティエ, PID_エーティエ)
MID_RELIANCE_C_#008	キャラカメラ(CharaCam_Front_Center_Mid, PID_エーティエ, cam_anim_track_l_normal)\nキャラモーション再生(PID_エーティエ, , EmoThinkOut,,1)\n*\nキャラモーション再生(PID_エーティエ, Normal, IdleNormal)
MID_RELIANCE_C_#009	キャラカメラ(CharaCam_SideLong_Right2_Mid, PID_フォガート, cam_anim_pan_l_slow)\nキャラモーション再生(PID_フォガート, , EmoTalk2,,1)\nキャラモーション再生(PID_フォガート, Relax,,3)\n*\nキャラモーション再生(PID_フォガート, Normal, IdleNormal,,1)
MID_RELIANCE_C_#010	キャラカメラ(CharaCam_FrontLong2_Left_Mid, PID_エーティエ, cam_anim_pan_l_normal)\nキャラモーション再生(PID_エーティエ, , EmoDeny,,1)\n*\nキャラモーション再生(PID_エーティエ, Normal, IdleNormal)
MID_RELIANCE_C_#011	キャラカメラ(CharaCam_Side_Right_Mid, PID_フォガート, cam_anim_dolly_r_normal)\n*\nキャラモーション再生(PID_フォガート, Surprise)
MID_RELIANCE_C_#012	キャラカメラ(CharaCam_Front_Center_Mid, PID_エーティエ, cam_anim_track_l_slow)\nキャラモーション再生(PID_エーティエ, , EmoProud,,1)
MID_RELIANCE_C_#013	キャラモーション再生(PID_エーティエ, Relax, IdleNormal,,1)
MID_RELIANCE_C_#014	キャラカメラ(CharaCam_Side_Right2_Mid, PID_フォガート, cam_anim_track_l_slow)\n*\nキャラモーション再生(PID_フォガート, Sad, IdleNormal)
MID_RELIANCE_C_#015	キャラカメラ(CharaCam_SideLong_Left2_Mid, PID_エーティエ, cam_anim_pan_u_slow)\nキャラモーション再生(PID_エーティエ, , EmoJoy2,,1)\n*\nキャラモーション再生(PID_エーティエ, Sad, IdleNormal)\nキャラ視線リセット(PID_エーティエ)
MID_RELIANCE_C_#016	キャラカメラ(CharaCam_Side_Right2_Mid, PID_フォガート, cam_anim_track_l_normal)\nキャラモーション再生(PID_フォガート, , EmoThink,,1)\n*\nキャラモーション再生(PID_フォガート, Relax, IdleNormal)
MID_RELIANCE_C_#017	キャラカメラ(CharaCam_Side_Left2_Mid, PID_エーティエ, cam_anim_track_r_normal)\nキャラモーション再生(PID_エーティエ, , EmoSad2,,1)\n*\nキャラ表示切替(PID_エーティエ, False)
MID_RELIANCE_C_#018	キャラカメラ(CharaCam_SideLong_Right2_Mid, PID_フォガート, cam_anim_pan_u_slow)\nキャラモーション再生(PID_フォガート, , EmoJoy)\n*\nフェードアウト()
MID_RELIANCE_B_#001	キャラ配置(PID_エーティエ, YOU_IN_C,, Normal, IdleNormal)\nキャラ配置(PID_フォガート, ME_IN_C,, Sad, IdleNormal)\n\n背景(Map_Event_Hub_Solanel_01_Day)\nライト(CharaLight_M001)\n\nキャラ視線(PID_エーティエ, PID_フォガート, PID_フォガート)\nキャラ視線(PID_フォガート, PID_エーティエ, PID_エーティエ)\n\nウェイト(0.4)\n\nシーンカメラ(SceneCam_SideMe_Left_Mid, cam_anim_zoom_in_normal)\nフェードイン()\n\nキャラモーション再生(PID_エーティエ, , EmoTalk2,,1)\n*\nキャラモーション再生(PID_エーティエ, Relax, IdleNormal)
MID_RELIANCE_B_#002	キャラカメラ(CharaCam_Side_Right2_Mid, PID_フォガート, cam_anim_track_l_slow)\nキャラモーション再生(PID_フォガート, , EmoThinkIn,,1)
MID_RELIANCE_B_#003	キャラモーション再生(PID_フォガート, , EmoThinkOut,,1)
MID_RELIANCE_B_#004	キャラカメラ(CharaCam_Side_Left2_Mid, PID_フォガート, cam_anim_track_r_slow)\nキャラモーション再生(PID_フォガート, , EmoDeny2,,1)
MID_RELIANCE_B_#005	
MID_RELIANCE_B_#006	キャラカメラ(CharaCam_FrontLong2_Right_Bot, PID_フォガート, cam_anim_track_l_slow)\nキャラモーション再生(PID_フォガート, Die, EmoSad,,1)\nキャラモーション再生(PID_フォガート, Sad,,3)\n*\nキャラモーション再生(PID_フォガート, Surprise, IdleNormal)
MID_RELIANCE_B_#007	キャラカメラ(CharaCam_Front_Center_Mid, PID_エーティエ, cam_anim_track_l_slow)\nキャラモーション再生(PID_エーティエ, , EmoJoy,,1)\n*\nキャラモーション再生(PID_エーティエ, Relax, IdleNormal,,1)
MID_RELIANCE_B_#008	キャラカメラ(CharaCam_FrontLong2_Right_Bot, PID_フォガート, cam_anim_pan_l_slow)\n*\nキャラモーション再生(PID_フォガート, Normal, IdleNormal)
MID_RELIANCE_B_#009	キャラカメラ(CharaCam_Side_Left2_Mid, PID_エーティエ, cam_anim_track_r_slow)\nキャラモーション再生(PID_エーティエ, , EmoProud,,1)\n*\nキャラモーション再生(PID_エーティエ, Angry, IdleNormal,,1)
MID_RELIANCE_B_#010	キャラカメラ(CharaCam_FrontLong2_Right_Bot, PID_フォガート, cam_anim_track_l_normal)\nキャラモーション再生(PID_フォガート, , EmoDeny,,1)\n*\nキャラモーション再生(PID_フォガート, Sad, IdleNormal)
MID_RELIANCE_B_#011	キャラカメラ(CharaCam_Front_Center_Mid, PID_エーティエ, cam_anim_track_l_normal )
MID_RELIANCE_B_#012	キャラカメラ(CharaCam_Side_Right2_Mid, PID_フォガート, cam_anim_track_l_slow)\nキャラモーション再生(PID_フォガート, , EmoDeny2,,1)\n*\nキャラモーション再生(PID_フォガート, Sad, IdleNormal)
MID_RELIANCE_B_#013	キャラカメラ(CharaCam_Side_Left_Mid, PID_エーティエ, cam_anim_dolly_l_normal)
MID_RELIANCE_B_#014	キャラカメラ(CharaCam_Side_Right_Mid, PID_フォガート, cam_anim_dolly_r_normal)\n*\nキャラモーション再生(PID_フォガート, Surprise, IdleNormal)
MID_RELIANCE_B_#015	キャラカメラ(CharaCam_FrontLong2_Left_Top, PID_エーティエ, cam_anim_pan_r_slow)\nキャラモーション再生(PID_エーティエ, , EmoTalk2,,1)\n*\nキャラモーション再生(PID_エーティエ, Relax, IdleNormal,,1)
MID_RELIANCE_B_#016	キャラカメラ(CharaCam_FrontLong2_Right_Bot, PID_フォガート, cam_anim_pan_r_slow)\nキャラモーション再生(PID_フォガート, , EmoDeny,,1)
MID_RELIANCE_B_#017	キャラモーション再生(PID_フォガート, Sad, EmoTalk,,1)\n*\nキャラモーション再生(PID_フォガート, Surprise, IdleNormal)
MID_RELIANCE_B_#018	キャラカメラ(CharaCam_Side_Left2_Top, PID_エーティエ, cam_anim_track_r_slow)\nキャラモーション再生(PID_エーティエ, , EmoThinkIn,,1)
MID_RELIANCE_B_#019	
MID_RELIANCE_B_#020	キャラカメラ(CharaCam_Side_Right3_Bot, PID_フォガート, cam_anim_zoom_in_slow)\n*\nキャラ表示切替(PID_フォガート, False)\nキャラモーション再生(PID_フォガート, Relax, IdleNormal)
MID_RELIANCE_B_#021	キャラカメラ(CharaCam_SideLong_Left2_Mid, PID_エーティエ, cam_anim_track3_l_normal)\nキャラモーション再生(PID_エーティエ, , EmoProud,,1)\n*\nキャラモーション再生(PID_エーティエ, Relax, IdleNormal)\nキャラ表示切替(PID_フォガート, True)
MID_RELIANCE_B_#022	キャラカメラ(CharaCam_Side_Right2_Mid, PID_フォガート, cam_anim_track_l_slow)\nキャラモーション再生(PID_フォガート, , EmoNod,,1)\n*\nフェードアウト()
MID_RELIANCE_A_#001	キャラ配置(PID_エーティエ, YOU_IN_C,, Relax, IdleNormal)\nキャラ配置(PID_フォガート, ME_IN_C,, Smile, IdleNormal)\n\nキャラ配置(PID_デモ用_視線設定用, ME_IN_A)\nキャラ配置調整(PID_デモ用_視線設定用, 0, -0.2, 0.3)\nキャラ表示切替(PID_デモ用_視線設定用, False)\n\n背景(Map_Event_Hub_Solanel_15_Day)\nライト(CharaLight_M001)\n\nキャラ視線(PID_エーティエ, PID_フォガート, PID_フォガート)\nキャラ視線(PID_フォガート, PID_エーティエ, PID_エーティエ)\n\nウェイト(0.4)\n\nキャラカメラ(CharaCam_Shoulder_Left_Top, PID_フォガート, cam_anim_track2_l_normal)\nフェードイン()\n\nキャラモーション再生(PID_エーティエ, , EmoRelax,,1)
MID_RELIANCE_A_#002	
MID_RELIANCE_A_#003	キャラカメラ(CharaCam_Side_Left2_Top, PID_エーティエ, cam_anim_track_r_normal)\nキャラモーション再生(PID_エーティエ, Normal, EmoTalk2,,1)\nキャラ視線(PID_エーティエ, PID_デモ用_視線設定用, PID_デモ用_視線設定用)\nキャラ回転(PID_エーティエ, 45, 1.3)\n\nキャラ視線(PID_フォガート, PID_デモ用_視線設定用, PID_デモ用_視線設定用)\nキャラ回転(PID_フォガート, -80, 0)\n*\nキャラモーション再生(PID_エーティエ, Normal, IdleNormal,,1)
MID_RELIANCE_A_#004	キャラカメラ(CharaCam_Shoulder_Left_Top, PID_フォガート, cam_anim_track_l_normal)\nキャラモーション再生(PID_フォガート, , EmoNod,,1)\n*\nキャラモーション再生(PID_フォガート,, IdleNormal,,1)
MID_RELIANCE_A_#005	キャラモーション再生(PID_エーティエ, Relax, EmoJoy,,1)
MID_RELIANCE_A_#006	キャラカメラ(CharaCam_Side_Left2_Mid, PID_エーティエ, cam_anim_track_l_slow)\nキャラモーション再生(PID_エーティエ, , EmoTalk2,,1)\nキャラ視線(PID_エーティエ, PID_フォガート, PID_フォガート)\n*\nキャラモーション再生(PID_エーティエ, Relax, IdleNormal)
MID_RELIANCE_A_#007	キャラカメラ(CharaCam_Side_Right_Mid, PID_フォガート, cam_anim_dolly_r_normal)\nキャラモーション再生(PID_フォガート, Surprise)\nキャラ視線(PID_フォガート, PID_エーティエ, PID_エーティエ)
MID_RELIANCE_A_#008	*\nキャラモーション再生(PID_フォガート, Normal)
MID_RELIANCE_A_#009	キャラカメラ(CharaCam_Side_Left_Mid, PID_エーティエ, cam_anim_dolly_l_normal)\nキャラモーション再生(PID_エーティエ, , EmoThink,,1)\n*\nキャラモーション再生(PID_エーティエ, Relax, IdleNormal)\nキャラ回転(PID_エーティエ, -45, 0)
MID_RELIANCE_A_#010	キャラカメラ(CharaCam_Side_Right2_Mid, PID_フォガート, cam_anim_track_r_slow)\nキャラ視線(PID_フォガート, PID_デモ用_視線設定用, PID_デモ用_視線設定用)\n*\nキャラモーション再生(PID_フォガート, Normal, IdleNormal)\nサウンドイベント(SE_Reliance_Lueur_Bonet_S_F)
MID_RELIANCE_A_#011	キャラカメラ(CharaCam_Side_Right2_Mid, PID_フォガート, cam_anim_track3_l_normal)\nキャラモーション再生(PID_フォガート, Die, EmoNod,, 0.3)\n*\nキャラモーション再生(PID_フォガート, Surprise, IdleNormal,, 1)
MID_RELIANCE_A_#012	キャラカメラ(CharaCam_Side_Right2_Mid, PID_フォガート, cam_anim_zoom_in_fast)\nサウンドイベント(SE_Reliance_Delicious)\n白フェードイン()\n\nキャラモーション再生(PID_フォガート, Relax, EmoJoy, 2.7, 1)\n*\nキャラモーション再生(PID_フォガート, Relax, IdleNormal)
MID_RELIANCE_A_#013	キャラカメラ(CharaCam_Side_Left2_Mid, PID_エーティエ, cam_anim_track_r_slow)
MID_RELIANCE_A_#014	キャラモーション再生(PID_エーティエ, , EmoJoy,,1)\n*\nキャラモーション再生(PID_エーティエ, Smile, IdleNormal,,1)
MID_RELIANCE_A_#015	キャラカメラ(CharaCam_FrontLong2_Right_Bot, PID_フォガート, cam_anim_pan_r_slow)\nキャラモーション再生(PID_フォガート, , TurnR,, 0.3)\nキャラモーション再生(PID_フォガート, , EmoJoy, 3, 1)\n\nキャラ視線(PID_フォガート, PID_エーティエ, PID_エーティエ)\nキャラ回転(PID_フォガート, 80, 1.5)
MID_RELIANCE_A_#016	キャラモーション再生(PID_フォガート, Smile, EmoTalk,,1)\n*\nキャラモーション再生(PID_フォガート, Relax, IdleNormal)
MID_RELIANCE_A_#017	キャラカメラ(CharaCam_Side_Left2_Mid, PID_エーティエ, cam_anim_track_r_normal)\n*\nキャラモーション再生(PID_エーティエ, Relax, IdleNormal)
MID_RELIANCE_A_#018	キャラカメラ(CharaCam_FrontLong2_Right_Bot, PID_フォガート, cam_anim_pan_l_normal)\nキャラモーション再生(PID_フォガート, , EmoTalk2,,1)\n*\nキャラモーション再生(PID_フォガート, Surprise, IdleNormal,,1)
MID_RELIANCE_A_#019	キャラカメラ(CharaCam_FrontLong2_Left_Top, PID_エーティエ, cam_anim_track2_l_normal)\nキャラモーション再生(PID_エーティエ, , EmoNod,,1)
MID_RELIANCE_A_#020	キャラモーション再生(PID_エーティエ, , EmoJoy,,1)\n*\nキャラモーション再生(PID_エーティエ, Relax, IdleNormal,,1)
MID_RELIANCE_A_#021	キャラカメラ(CharaCam_FrontLong2_Right_Bot, PID_フォガート, cam_anim_pan_r_normal)\nキャラモーション再生(PID_フォガート, , EmoDeny,,1)\n*\nキャラモーション再生(PID_フォガート, Normal, IdleNormal)
MID_RELIANCE_A_#022	キャラカメラ(CharaCam_SideLong_Left2_Mid, PID_エーティエ, cam_anim_track3_r_normal)\nキャラモーション再生(PID_エーティエ, , EmoThinkIn,,1)
MID_RELIANCE_A_#023	キャラモーション再生(PID_エーティエ, , EmoRelax,,1)\n*\nキャラモーション再生(PID_エーティエ, Smile, IdleNormal)
MID_RELIANCE_A_#024	キャラカメラ(CharaCam_Side_Right2_Mid, PID_フォガート, cam_anim_track_r_slow)\nキャラモーション再生(PID_フォガート, , EmoNod,,1)\nキャラモーション再生(PID_フォガート, Sad, EmoThink, 1.5, 1)\n*\nキャラモーション再生(PID_フォガート, Surprise, IdleNormal)
MID_RELIANCE_A_#025	キャラカメラ(CharaCam_Side_Left3_Top, PID_エーティエ, cam_anim_track3_l_normal)\nキャラモーション再生(PID_エーティエ, , EmoJoy,,1)\n*\nキャラモーション再生(PID_エーティエ, , IdleNormal)
MID_RELIANCE_A_#026	キャラカメラ(CharaCam_Side_Right3_Mid, PID_フォガート, cam_anim_zoom_in_slow)\nキャラモーション再生(PID_フォガート, Surprise, EmoSurprise,,1)\n*\nフェードアウト()
