MID_RELIANCE_C_#001	キャラ配置(PID_ジェーデ, YOU_IN_C, [服装], Normal, IdleNormal, 0)\nキャラ配置(PID_ロサード, ME_IN_C, [服装], Normal, IdleNormal, 0)\n\n背景(Map_Event_Hub_Solanel_01_Day)\nライト(CharaLight_Hub_Day, 0, 0, 0)\n\nキャラ視線(PID_ジェーデ, PID_ロサード, PID_ロサード)\nキャラ視線(PID_ロサード, PID_ジェーデ, PID_ジェーデ)\n\nウェイト(1)\n\nキャラカメラ(CharaCam_Shoulder_Left_Mid, PID_ロサード, cam_anim_track2_l_normal)\n\nフェードイン()
MID_RELIANCE_C_#002	キャラモーション再生(PID_ロサード, Relax, EmoSad,, 0.3)\n\nキャラカメラ(CharaCam_Front_Center_Top, PID_ロサード, cam_anim_zoom_out_slow)
MID_RELIANCE_C_#003	キャラモーション再生(PID_ロサード, Sad)\nキャラモーション再生(PID_ロサード, Normal, EmoProud, 3.6, 1)
MID_RELIANCE_C_#004	キャラモーション再生(PID_ロサード, Normal, IdleNormal)\n\nキャラカメラ(CharaCam_Side_Left2_Mid, PID_ジェーデ, cam_anim_track_r_normal)
MID_RELIANCE_C_#005	キャラモーション再生(PID_ロサード, Sad)\n\nキャラカメラ(CharaCam_Side_Right2_Mid, PID_ロサード, cam_anim_track_l_normal)
MID_RELIANCE_C_#006	キャラモーション再生(PID_ジェーデ, Normal, EmoTalk2, 1.8, 0.3)\n\nキャラカメラ(CharaCam_Front_Center_Mid, PID_ジェーデ, cam_anim_zoom_out_normal)
MID_RELIANCE_C_#007	キャラモーション再生(PID_ロサード, Normal)\nキャラモーション再生(PID_ロサード, Normal, EmoNod, 1.5, 0.3)\nキャラモーション再生(PID_ジェーデ, Normal, IdleNormal)\n\nキャラカメラ(CharaCam_Front_Center2_Mid, PID_ロサード, cam_anim_pan_d_normal)
MID_RELIANCE_C_#008	キャラモーション再生(PID_ロサード, Normal, IdleNormal)\n\nキャラカメラ(CharaCam_Side_Left2_Mid, PID_ジェーデ, cam_anim_track_r_slow)
MID_RELIANCE_C_#009	キャラモーション再生(PID_ジェーデ, Normal, EmoTalk,, 0.3)
MID_RELIANCE_C_#010	キャラカメラ(CharaCam_Shoulder_Left_Mid, PID_ロサード, cam_anim_zoom_in_normal)
MID_RELIANCE_C_#011	キャラモーション再生(PID_ロサード, Normal, EmoSad2,, 0.3)\nキャラモーション再生(PID_ジェーデ, Normal, IdleNormal)\n\nキャラカメラ(CharaCam_Side_Right2_Top, PID_ロサード, cam_anim_zoom_in_slow)
MID_RELIANCE_C_#012	キャラモーション再生(PID_ロサード, Smile)\nキャラモーション再生(PID_ロサード, Smile, EmoTalk, 2, 1)
MID_RELIANCE_C_#013	キャラモーション再生(PID_ジェーデ, Normal, EmoNod)\nキャラモーション再生(PID_ジェーデ, Normal, IdleNormal, 1.5, 1)\nキャラモーション再生(PID_ロサード, Smile, IdleNormal)\n\nキャラカメラ(CharaCam_Front_Center_Top, PID_ジェーデ, cam_anim_zoom_out_slow)
MID_RELIANCE_C_#014	
MID_RELIANCE_C_#015	キャラモーション再生(PID_ジェーデ, Normal, EmoThink,, 1)
MID_RELIANCE_C_#016	キャラモーション再生(PID_ロサード, Smile, EmoTalk2,, 0.3)\nキャラモーション再生(PID_ジェーデ, Normal, IdleNormal)\n\nキャラカメラ(CharaCam_Front_Center2_Mid, PID_ロサード, cam_anim_pan_d_normal)\n\n*\n\nフェードアウト()
MID_RELIANCE_B_#001	キャラ配置(PID_ジェーデ, ME_IN_C, [服装], Normal, IdleNormal, 0)\nキャラ配置(PID_ロサード, YOU_IN_C, [服装], Normal, IdleNormal, 0)\n\n背景(Map_Event_Hub_Solanel_05_Day)\nライト(CharaLight_Hub_Day, 0, 0, 0)\n\nキャラ視線(PID_ジェーデ, PID_ロサード, PID_ロサード)\nキャラ視線(PID_ロサード, PID_ジェーデ, PID_ジェーデ)\n\nウェイト(1)\n\nキャラモーション再生(PID_ロサード, Normal, EmoTalk, 2.5, 0.3)\n\nキャラカメラ(CharaCam_Shoulder_Right_Top, PID_ジェーデ, cam_anim_track_r_normal)\n\nフェードイン()
MID_RELIANCE_B_#002	キャラモーション再生(PID_ジェーデ, Normal, EmoThink,, 0.3)\nキャラモーション再生(PID_ロサード, Normal, IdleNormal)\n\nキャラカメラ(CharaCam_Side_Left2_Mid, PID_ジェーデ, cam_anim_track_r_normal)
MID_RELIANCE_B_#003	キャラモーション再生(PID_ジェーデ, Normal, IdleNormal)\n\nキャラカメラ(CharaCam_Side_Right2_Mid, PID_ロサード, cam_anim_track_l_normal)
MID_RELIANCE_B_#004	キャラモーション再生(PID_ジェーデ, Die)\n\nキャラカメラ(CharaCam_Front_Center_Top, PID_ジェーデ, cam_anim_zoom_out_slow)\n\n*\n\nパペット会話中断()\n\nキャラモーション再生(PID_ジェーデ, Normal, EmoJoy,, 0.3)\n\nウェイト(1)
MID_RELIANCE_B_#005	\n
MID_RELIANCE_B_#006	キャラモーション再生(PID_ロサード, Smile, EmoNod,, 0.3)\nキャラモーション再生(PID_ロサード, Smile, IdleNormal, 2, 1)\nキャラモーション再生(PID_ジェーデ, Normal, IdleNormal)\n\nキャラカメラ(CharaCam_Front_Center2_Mid, PID_ロサード, cam_anim_pan_d_normal)\n
MID_RELIANCE_B_#007	キャラモーション再生(PID_ロサード, Relax, IdleNormal)\n\nキャラカメラ(CharaCam_Side_Left2_Mid, PID_ジェーデ, cam_anim_track_r_normal)
MID_RELIANCE_B_#008	キャラモーション再生(PID_ロサード, Normal)\nキャラモーション再生(PID_ロサード, Smile,, 1.7)\n\nキャラカメラ(CharaCam_Side_Right2_Mid, PID_ロサード, cam_anim_track_l_normal)
MID_RELIANCE_B_#009	キャラモーション再生(PID_ジェーデ, Normal, EmoJoy, 0.5, 0.3)\nキャラモーション再生(PID_ロサード, Smile, IdleNormal)\n\nキャラカメラ(CharaCam_Front_Center2_Mid, PID_ジェーデ, cam_anim_pan_d_normal)
MID_RELIANCE_B_#010	キャラモーション再生(PID_ロサード, Surprise)\nキャラモーション再生(PID_ロサード, Relax, EmoTalk, 1.2, 0.3)\nキャラモーション再生(PID_ジェーデ, Normal, IdleNormal)\n\nキャラカメラ(CharaCam_Front_Center_Top, PID_ロサード, cam_anim_pan_u_normal)
MID_RELIANCE_B_#011	キャラモーション再生(PID_ジェーデ, Die)\nキャラモーション再生(PID_ロサード, Relax, IdleNormal)\n\nキャラカメラ(CharaCam_Side_Left2_Top, PID_ジェーデ, cam_anim_zoom_in_normal)
MID_RELIANCE_B_#012	キャラモーション再生(PID_ロサード, Sad, EmoThink,, 0.3)\nキャラモーション再生(PID_ジェーデ, Die, IdleNormal)\n\nキャラカメラ(CharaCam_Side_Right2_Mid, PID_ロサード, cam_anim_track_l_normal)
MID_RELIANCE_B_#013	キャラモーション再生(PID_ジェーデ, Normal, EmoDeny2,, 0.3)\nキャラモーション再生(PID_ロサード, Sad, IdleNormal)\n\nキャラカメラ(CharaCam_Side_Left2_Mid, PID_ジェーデ, cam_anim_track_r_slow)
MID_RELIANCE_B_#014	キャラモーション再生(PID_ジェーデ, Normal, EmoThink, 3, 1)
MID_RELIANCE_B_#015	キャラモーション再生(PID_ロサード, Relax)\nキャラモーション再生(PID_ロサード, Relax, EmoProud, 5, 0.3)\nキャラモーション再生(PID_ジェーデ, Normal, IdleNormal)\n\nキャラカメラ(CharaCam_Side_Right3_Mid, PID_ロサード, cam_anim_pan_d_normal)
MID_RELIANCE_B_#016	キャラモーション再生(PID_ロサード, Relax, IdleNormal)\n\nキャラカメラ(CharaCam_Front_Center_Top, PID_ジェーデ, cam_anim_zoom_out_slow)
MID_RELIANCE_B_#017	キャラモーション再生(PID_ジェーデ, Normal, EmoTalk,, 0.3)
MID_RELIANCE_B_#018	キャラモーション再生(PID_ロサード, Normal, EmoNod,, 0.3)\nキャラモーション再生(PID_ロサード, Normal, IdleNormal, 2, 1)\nキャラモーション再生(PID_ジェーデ, Normal, IdleNormal)\n\nキャラカメラ(CharaCam_Front_Center2_Mid, PID_ロサード, cam_anim_zoom_in_normal)\n\n*\n\nフェードアウト()
MID_RELIANCE_A_#001	キャラ配置(PID_ジェーデ, YOU_IN_C, [服装], Normal, IdleNormal, 0)\nキャラ配置(PID_ロサード, ME_IN_C, [服装], Normal, IdleNormal, 0)\n\n背景(Map_Event_Hub_Solanel_01_Day)\nライト(CharaLight_Hub_Day, 0, 0, 0)\n\nキャラ視線(PID_ジェーデ, PID_ロサード, PID_ロサード)\nキャラ視線(PID_ロサード, PID_ジェーデ, PID_ジェーデ)\n\nウェイト(1)\n\nキャラモーション再生(PID_ジェーデ, Normal, EmoJoy2, 3, 0.3)\n\nキャラカメラ(CharaCam_Shoulder_Left_Mid, PID_ロサード, cam_anim_track2_l_normal)\n\nフェードイン()
MID_RELIANCE_A_#002	キャラモーション再生(PID_ロサード, Surprise)\nキャラモーション再生(PID_ロサード, Relax, EmoTalk, 4.3, 0.3)\nキャラモーション再生(PID_ジェーデ, Normal, IdleNormal)\n\nキャラカメラ(CharaCam_Side_Right2_Mid, PID_ロサード, cam_anim_track_l_normal)
MID_RELIANCE_A_#003	キャラモーション再生(PID_ロサード, Relax, IdleNormal)\n\nキャラカメラ(CharaCam_Side_Left2_Mid, PID_ジェーデ, cam_anim_track_r_normal)
MID_RELIANCE_A_#004	キャラモーション再生(PID_ロサード, Smile)\nキャラモーション再生(PID_ロサード, Shy, EmoSad, 1.3, 0.3)\n\nキャラカメラ(CharaCam_Front_Center_Mid, PID_ロサード, cam_anim_zoom_out_normal)
MID_RELIANCE_A_#005	キャラモーション再生(PID_ジェーデ, Normal, EmoThink, 1.7, 0.3)\nキャラモーション再生(PID_ロサード, Shy, IdleNormal)\n\nキャラカメラ(CharaCam_Front_Center_Top, PID_ジェーデ, cam_anim_pan_u_normal)
MID_RELIANCE_A_#006	キャラモーション再生(PID_ロサード, Normal)\nキャラモーション再生(PID_ジェーデ, Normal, IdleNormal)\n\nキャラカメラ(CharaCam_Side_Right2_Mid, PID_ロサード, cam_anim_track_l_normal)
MID_RELIANCE_A_#007	キャラモーション再生(PID_ジェーデ, Die)\n\nキャラカメラ(CharaCam_Side_Left2_Mid, PID_ジェーデ, cam_anim_track_r_normal)
MID_RELIANCE_A_#008	キャラモーション再生(PID_ロサード, Normal, EmoDeny2,, 1)\n\nキャラカメラ(CharaCam_Side_Right3_Mid, PID_ロサード, cam_anim_pan_d_normal)
MID_RELIANCE_A_#009	キャラモーション再生(PID_ジェーデ, Normal)\nキャラモーション再生(PID_ジェーデ, Normal, EmoRelax, 0.5, 0.3)\nキャラモーション再生(PID_ロサード, Normal, IdleNormal)\n\nキャラカメラ(CharaCam_Front_Center_Top, PID_ジェーデ, cam_anim_pan_u_normal)
MID_RELIANCE_A_#010	キャラモーション再生(PID_ロサード, Relax, EmoNod,, 0.3)\nキャラモーション再生(PID_ロサード, Relax, IdleNormal, 2, 1)\nキャラモーション再生(PID_ジェーデ, Normal, IdleNormal)\n\nキャラカメラ(CharaCam_Side_Right2_Mid, PID_ロサード, cam_anim_track_l_normal)
MID_RELIANCE_A_#011	キャラモーション再生(PID_ロサード, Relax, IdleNormal)\n\nキャラカメラ(CharaCam_Side_Left2_Mid, PID_ジェーデ, cam_anim_track_r_slow)
MID_RELIANCE_A_#012	キャラモーション再生(PID_ジェーデ, Normal, EmoDeny2,, 0.3)
MID_RELIANCE_A_#013	キャラモーション再生(PID_ジェーデ, Normal, IdleNormal,, 1)\n\nキャラカメラ(CharaCam_Shoulder_Left_Mid, PID_ロサード, cam_anim_track2_l_normal)
MID_RELIANCE_A_#014	キャラモーション再生(PID_ジェーデ, Die)\nキャラモーション再生(PID_ジェーデ, Normal,, 3)
MID_RELIANCE_A_#015	キャラモーション再生(PID_ジェーデ, Smile, EmoRelax,, 0.3)\n\nキャラカメラ(CharaCam_Front_Center2_Mid, PID_ジェーデ, cam_anim_zoom_in_normal)
MID_RELIANCE_A_#016	キャラモーション再生(PID_ロサード, Surprise)\nキャラモーション再生(PID_ジェーデ, Smile, IdleNormal)\n\nキャラカメラ(CharaCam_Front_Center_Top, PID_ロサード, cam_anim_zoom_out_slow)
MID_RELIANCE_A_#017	
MID_RELIANCE_A_#018	キャラモーション再生(PID_ロサード, Surprise, EmoTalk2, 0.5, 0.3)
MID_RELIANCE_A_#019	キャラモーション再生(PID_ジェーデ, Normal)\nキャラモーション再生(PID_ジェーデ, Normal, EmoTalk2, 2, 0.3)\nキャラモーション再生(PID_ロサード, Surprise, IdleNormal)\n\nキャラカメラ(CharaCam_Front_Center2_Mid, PID_ジェーデ, cam_anim_pan_d_normal)
MID_RELIANCE_A_#020	キャラモーション再生(PID_ロサード, Smile)\nキャラモーション再生(PID_ロサード, Smile, EmoSad2, 0.7, 0.3)\nキャラモーション再生(PID_ジェーデ, Smile, IdleNormal)\n\nキャラカメラ(CharaCam_Front_Center_Top, PID_ロサード, cam_anim_pan_u_normal)\n\n*\n\nフェードアウト()
