MID_RELIANCE_C_#001	キャラ配置(PID_カゲツ, YOU_IN_C, [服装], Normal, IdleNormal, 0)\nキャラ配置(PID_メリン, ME_IN_C, [服装], Normal, IdleNormal, 0)\n\n背景(Map_Event_Hub_Solanel_06_Day)\nライト(CharaLight_Hub_Day, 0, 0, 0)\n\nキャラ視線(PID_メリン, PID_カゲツ, PID_カゲツ)\n\nキャラモーション再生(PID_カゲツ, Sad)\n\nウェイト(1)\n\nキャラカメラ(CharaCam_Front_Center2_Mid, PID_カゲツ, cam_anim_pan_d_slow)\n\nフェードイン()
MID_RELIANCE_C_#002	
MID_RELIANCE_C_#003	キャラモーション再生(PID_カゲツ, Die, EmoTired,, 0.3)\nキャラモーション再生(PID_メリン, Normal, WalkIn)\n\nキャラカメラ(CharaCam_FrontLong2_Left_Bot, PID_カゲツ, cam_anim_pan_l_normal)\n\n*\n\nパペット会話中断()
MID_RELIANCE_C_#004	キャラモーション待ち(PID_カゲツ)\n\nキャラモーション再生(PID_メリン, Normal, EmoGive, 2.7, 0.3)\nキャラモーション再生(PID_カゲツ, Sad, IdleNormal)\n\nキャラ視線(PID_カゲツ, PID_メリン, PID_メリン)\n\nキャラカメラ(CharaCam_Front_Center2_Mid, PID_メリン, cam_anim_pan_d_normal)
MID_RELIANCE_C_#005	キャラモーション再生(PID_メリン, Normal, IdleNormal,, 1)\n\nキャラカメラ(CharaCam_Shoulder_Left_Mid, PID_メリン, cam_anim_zoom_in_normal)
MID_RELIANCE_C_#006	キャラモーション再生(PID_カゲツ, Shy, EmoThink,, 0.3)\n\nキャラカメラ(CharaCam_Front_Center_Top, PID_カゲツ, cam_anim_pan_u_normal)
MID_RELIANCE_C_#007	
MID_RELIANCE_C_#008	キャラモーション再生(PID_メリン, Smile)\nキャラモーション再生(PID_カゲツ, Shy, IdleNormal)\n\nキャラカメラ(CharaCam_Side_Right3_Mid, PID_メリン, cam_anim_pan_d_normal)
MID_RELIANCE_C_#009	キャラモーション再生(PID_カゲツ, Smile, EmoNod)\n\nキャラカメラ(CharaCam_Side_Left2_Mid, PID_カゲツ, cam_anim_track_r_normal)
MID_RELIANCE_C_#010	キャラモーション再生(PID_メリン, Smile, EmoThink,, 1)\nキャラモーション再生(PID_カゲツ, Smile, IdleNormal)\n\nキャラカメラ(CharaCam_Side_Right2_Mid, PID_メリン, cam_anim_track_l_normal)
MID_RELIANCE_C_#011	キャラモーション再生(PID_カゲツ, Smile, EmoTalk)\nキャラモーション再生(PID_メリン, Smile, IdleNormal)\n\nキャラカメラ(CharaCam_Side_Left3_Mid, PID_カゲツ, cam_anim_pan_d_slow)
MID_RELIANCE_C_#012	
MID_RELIANCE_C_#013	キャラモーション再生(PID_メリン, Surprise)\nキャラモーション再生(PID_カゲツ, Smile, IdleNormal)\n\nキャラカメラ(CharaCam_Front_Center2_Mid, PID_メリン, cam_anim_pan_d_slow)
MID_RELIANCE_C_#014	キャラモーション再生(PID_メリン, Angry, EmoDeny, 2.3, 0.3)
MID_RELIANCE_C_#015	キャラモーション再生(PID_メリン, Angry, IdleNormal)\n\nキャラカメラ(CharaCam_Side_Left2_Mid, PID_カゲツ, cam_anim_track_r_slow)
MID_RELIANCE_C_#016	キャラモーション再生(PID_カゲツ, Smile, EmoTalk2,, 0.3)
MID_RELIANCE_C_#017	キャラモーション再生(PID_カゲツ, Smile, IdleNormal)\n\nキャラカメラ(CharaCam_Side_Right2_Mid, PID_メリン, cam_anim_track_l_normal)
MID_RELIANCE_C_#018	キャラモーション再生(PID_カゲツ, Angry)\n\nキャラカメラ(CharaCam_Shoulder_Left_Mid, PID_メリン, cam_anim_zoom_in_normal)
MID_RELIANCE_C_#019	キャラモーション再生(PID_メリン, Serious)\n\nキャラカメラ(CharaCam_Front_Center_Top, PID_メリン, cam_anim_zoom_out_slow)
MID_RELIANCE_C_#020	キャラモーション再生(PID_メリン, Angry, EmoTalk,, 0.3)
MID_RELIANCE_C_#021	キャラモーション再生(PID_カゲツ, Smile)\nキャラモーション再生(PID_メリン, Angry, IdleNormal)\n\nキャラカメラ(CharaCam_Side_Left2_Mid, PID_カゲツ, cam_anim_track_r_slow)
MID_RELIANCE_C_#022	キャラモーション再生(PID_カゲツ, Normal)
MID_RELIANCE_C_#023	キャラモーション再生(PID_カゲツ, Normal, EmoNod,, 0.3)
MID_RELIANCE_C_#024	キャラモーション再生(PID_カゲツ, Normal, IdleNormal)\n\nキャラカメラ(CharaCam_Side_Right2_Mid, PID_メリン, cam_anim_track_l_normal)
MID_RELIANCE_C_#025	キャラカメラ(CharaCam_Front_Center2_Mid, PID_カゲツ, cam_anim_pan_d_slow)
MID_RELIANCE_C_#026	キャラモーション再生(PID_カゲツ, Normal, EmoTalk,, 0.3)\n\n*\n\nフェードアウト()
MID_RELIANCE_B_#001	キャラ配置(PID_カゲツ, YOU_IN_C, [服装], Normal, IdleNormal, 0)\nキャラ配置(PID_メリン, ME_IN_C, [服装], Normal, IdleNormal, 0)\n\n背景(Map_Event_Hub_Solanel_01_Day)\nライト(CharaLight_Hub_Day, 0, 0, 0)\n\nキャラ視線(PID_カゲツ, PID_メリン, PID_メリン)\nキャラ視線(PID_メリン, PID_カゲツ, PID_カゲツ)\n\nウェイト(1)\n\nキャラモーション再生(PID_カゲツ, Normal, EmoTalk, 2, 0.3)\n\nキャラカメラ(CharaCam_Shoulder_Right_Mid, PID_メリン, cam_anim_track2_r_normal)\n\nフェードイン()
MID_RELIANCE_B_#002	キャラモーション再生(PID_メリン, Angry, EmoDeny2,, 0.3)\nキャラモーション再生(PID_カゲツ, Normal, IdleNormal)\n\nキャラカメラ(CharaCam_Front_Center_Top, PID_メリン, cam_anim_pan_u_normal)
MID_RELIANCE_B_#003	キャラモーション再生(PID_カゲツ, Sad, EmoThink)\nキャラモーション再生(PID_メリン, Angry, IdleNormal)\n\nキャラカメラ(CharaCam_Side_Right2_Mid, PID_カゲツ, cam_anim_track_l_slow)
MID_RELIANCE_B_#004	キャラモーション再生(PID_カゲツ, Normal)
MID_RELIANCE_B_#005	キャラモーション再生(PID_メリン, Sad, EmoSad,, 0.3)\nキャラモーション再生(PID_カゲツ, Normal, IdleNormal)\n\nキャラカメラ(CharaCam_Side_Left2_Mid, PID_メリン, cam_anim_track_r_normal)
MID_RELIANCE_B_#006	キャラモーション再生(PID_メリン, Sad, IdleNormal)\n\nキャラカメラ(CharaCam_Side_Right2_Top, PID_カゲツ, cam_anim_zoom_in_normal)
MID_RELIANCE_B_#007	キャラモーション再生(PID_メリン, Surprise)\n\nキャラカメラ(CharaCam_Front_Center_Top, PID_メリン, cam_anim_pan_u_normal)
MID_RELIANCE_B_#008	キャラモーション再生(PID_メリン, Normal)\n\nキャラカメラ(CharaCam_Front_Center2_Mid, PID_カゲツ, cam_anim_pan_d_normal)
MID_RELIANCE_B_#009	キャラモーション再生(PID_カゲツ, Normal, EmoTalk,, 0.3)\n\nキャラカメラ(CharaCam_FrontLong2_Right_Mid, PID_カゲツ, cam_anim_track_l_slow)
MID_RELIANCE_B_#010	
MID_RELIANCE_B_#011	キャラカメラ(CharaCam_Side_Right3_Bot, PID_カゲツ, cam_anim_pan_d_slow)
MID_RELIANCE_B_#012	キャラモーション再生(PID_カゲツ, Smile)
MID_RELIANCE_B_#013	キャラモーション再生(PID_カゲツ, Smile, IdleNormal)\n\nキャラカメラ(CharaCam_Front_Center2_Mid, PID_メリン, cam_anim_pan_d_slow)
MID_RELIANCE_B_#014	キャラモーション再生(PID_メリン, Normal, EmoRelax,, 1)
MID_RELIANCE_B_#015	キャラモーション再生(PID_カゲツ, Normal)\nキャラモーション再生(PID_メリン, Normal, IdleNormal)\n\nキャラカメラ(CharaCam_Front_Center_Top, PID_カゲツ, cam_anim_pan_u_normal)
MID_RELIANCE_B_#016	キャラモーション再生(PID_メリン, Normal, EmoNod,, 0.3)\n\nキャラカメラ(CharaCam_Side_Left2_Mid, PID_メリン, cam_anim_track_r_normal)
MID_RELIANCE_B_#017	キャラモーション再生(PID_メリン, Normal, IdleNormal)\n\nキャラカメラ(CharaCam_Side_Right2_Mid, PID_カゲツ, cam_anim_track_l_slow)
MID_RELIANCE_B_#018	
MID_RELIANCE_B_#019	キャラモーション再生(PID_メリン, Smile, EmoProud,, 0.3)\n\nキャラカメラ(CharaCam_Front_Center_Top, PID_メリン, cam_anim_pan_u_normal)
MID_RELIANCE_B_#020	キャラモーション再生(PID_カゲツ, Relax, EmoSad,, 0.3)\nキャラモーション再生(PID_メリン, Smile, IdleNormal)\n\nキャラカメラ(CharaCam_Side_Right3_Mid, PID_カゲツ, cam_anim_pan_d_normal)\n\n*\n\nフェードアウト()
MID_RELIANCE_A_#001	キャラ配置(PID_カゲツ, ME_IN_C, [服装], Normal, IdleNormal, 0)\nキャラ配置(PID_メリン, YOU_IN_C, [服装], Normal, IdleNormal, 0)\n\nキャラアニメーター切替(PID_カゲツ, Unit/Anim/UnitAnims/UAS_Swd1AM)\nキャラ武器装備(PID_カゲツ, 鉄の剣)\nキャラアニメーター切替(PID_メリン, Unit/Anim/UnitAnims/UAS_Swd1AF)\nキャラ武器装備(PID_メリン, 鉄の剣)\n\n背景(Map_Event_Hub_Solanel_07_Day)\nライト(CharaLight_Hub_Day, 0, 0, 0)\n\nキャラ視線(PID_カゲツ, PID_メリン, PID_メリン)\nキャラ視線(PID_メリン, PID_カゲツ, PID_カゲツ)\n\nキャラモーション再生(PID_カゲツ, Strike, IdleNormal_Sword)\nキャラモーション再生(PID_メリン, Normal, IdleNormal_Sword)\n\nウェイト(1)\n\nキャラモーション再生(PID_カゲツ, Strike, Start_Sword,, 0.1)\n\nキャラカメラ(CharaCam_FrontLong2_Left_Bot, PID_カゲツ, cam_anim_pan_l_normal)\nフェードイン()\n\n*\n\nパペット会話中断()\n\n一枚絵表示(Tex_Event_Effect_Black)\n\nウェイト(1)
MID_RELIANCE_A_#002	
MID_RELIANCE_A_#003	キャラ武器装備解除(PID_カゲツ)\nキャラアニメーター切替(PID_カゲツ, Unit/Anim/Demo/AOC_Demo_c302)\nキャラ武器装備解除(PID_メリン)\nキャラアニメーター切替(PID_メリン, Unit/Anim/Demo/AOC_Demo_c452)
MID_RELIANCE_A_#004	
MID_RELIANCE_A_#005	\n*\n\nキャラモーション再生(PID_カゲツ, Pain)\n\nパペット会話中断()\n\nウェイト(1)\n\n一枚絵非表示()
MID_RELIANCE_A_#006	キャラカメラ(CharaCam_Side_Right3_Bot, PID_メリン, cam_anim_pan_d_normal)
MID_RELIANCE_A_#007	キャラカメラ(CharaCam_Front_Center_Top, PID_カゲツ, cam_anim_pan_u_normal)
MID_RELIANCE_A_#008	キャラモーション再生(PID_カゲツ, Serious)\n\nキャラカメラ(CharaCam_Side_Right2_Mid, PID_メリン, cam_anim_track_l_slow)
MID_RELIANCE_A_#009	キャラモーション再生(PID_メリン, Normal, EmoRelax,, 1)
MID_RELIANCE_A_#010	キャラモーション再生(PID_メリン, Normal, IdleNormal)\n\nキャラカメラ(CharaCam_Side_Left2_Mid, PID_カゲツ, cam_anim_track_r_normal)
MID_RELIANCE_A_#011	キャラモーション再生(PID_メリン, Normal, EmoTalk2)\n\nキャラカメラ(CharaCam_Front_Center_Top, PID_メリン, cam_anim_pan_u_normal)
MID_RELIANCE_A_#012	キャラモーション再生(PID_カゲツ, Normal, EmoNod)\nキャラモーション再生(PID_メリン, Normal, IdleNormal)\n\nキャラカメラ(CharaCam_Front_Center2_Mid, PID_カゲツ, cam_anim_pan_d_normal)
MID_RELIANCE_A_#013	キャラモーション再生(PID_カゲツ, Normal, EmoTalk,, 1)
MID_RELIANCE_A_#014	キャラモーション再生(PID_メリン, Normal, EmoThink,, 0.3)\nキャラモーション再生(PID_カゲツ, Normal, IdleNormal)\n\nキャラカメラ(CharaCam_Side_Right2_Mid, PID_メリン, cam_anim_track_l_normal)
MID_RELIANCE_A_#015	キャラモーション再生(PID_メリン, Normal, IdleNormal)\n\nキャラカメラ(CharaCam_Side_Left2_Mid, PID_カゲツ, cam_anim_track_r_slow)
MID_RELIANCE_A_#016	キャラモーション再生(PID_カゲツ, Relax)
MID_RELIANCE_A_#017	キャラモーション再生(PID_カゲツ, Normal)\n\nキャラカメラ(CharaCam_Shoulder_Left_Mid, PID_メリン, cam_anim_track2_l_normal)
MID_RELIANCE_A_#018	キャラモーション再生(PID_カゲツ, Normal, EmoTalk2, 1.5, 0.3)
MID_RELIANCE_A_#019	キャラモーション再生(PID_メリン, Smile, EmoNod,, 0.3)\nキャラモーション再生(PID_カゲツ, Normal, IdleNormal)\n\nキャラカメラ(CharaCam_Side_Right3_Mid, PID_メリン, cam_anim_pan_d_slow)
MID_RELIANCE_A_#020	
MID_RELIANCE_A_#021	キャラモーション再生(PID_カゲツ, Smile, EmoProud)\nキャラモーション再生(PID_メリン, Smile, IdleNormal)\n\nキャラカメラ(CharaCam_Side_Left2_Top, PID_カゲツ, cam_anim_track_r_slow)
MID_RELIANCE_A_#022	
MID_RELIANCE_A_#023	キャラモーション再生(PID_メリン, Smile, EmoProud,, 0.3)\nキャラモーション再生(PID_カゲツ, Smile, IdleNormal)\n\nキャラカメラ(CharaCam_Side_Right2_Mid, PID_メリン, cam_anim_track_l_normal)\n\n*\n\nフェードアウト()
