MID_RELIANCE_C_#001	キャラ配置(PID_ルイ, YOU_IN_C,, Normal, IdleNormal)\nキャラ配置(PID_ユナカ, ME_IN_C,, Normal, IdleNormal, 75)\n\n背景(Map_Event_Hub_Solanel_01_Day)\nライト(CharaLight_Hub_Day)\n\nキャラ視線(PID_ルイ, PID_ユナカ, PID_ユナカ)\n\nウェイト(0.4)\n\nシーンカメラ(SceneCam_SideYou_Right_Mid, cam_anim_zoom_in_slow)\nキャラモーション再生(PID_ユナカ, , WalkIn2)\n\nフェードイン()\n\nキャラ視線(PID_ユナカ, PID_ルイ, PID_ルイ, 1)\nキャラモーション再生(PID_ルイ, , EmoTalk2,,1)\n*\nキャラモーション再生(PID_ルイ, Normal, IdleNormal,,1)
MID_RELIANCE_C_#002	キャラカメラ(CharaCam_FrontLong2_Right_Top, PID_ユナカ, cam_anim_pan_r_normal)\nキャラ回転(PID_ユナカ, -75, 1.2)\nキャラモーション再生(PID_ユナカ, , TurnL,, 0.8)\nキャラ視線(PID_ユナカ, PID_ルイ, PID_ルイ)\n*\nキャラモーション再生(PID_ユナカ, Smile, IdleNormal)
MID_RELIANCE_C_#003	キャラカメラ(CharaCam_SideLong_Left2_Mid, PID_ルイ, cam_anim_track3_r_normal)\nキャラモーション再生(PID_ルイ, , EmoNod,,1)
MID_RELIANCE_C_#004	キャラモーション再生(PID_ルイ, , EmoTalk,,1)\n*\nキャラモーション再生(PID_ルイ, Normal, IdleNormal,,1)
MID_RELIANCE_C_#005	キャラカメラ(CharaCam_FrontLong2_Right_Top, PID_ユナカ, cam_anim_pan_r_normal)\nキャラモーション再生(PID_ユナカ, , EmoJoy,,1)\n*\nキャラモーション再生(PID_ユナカ, Normal, IdleNormal)
MID_RELIANCE_C_#006	キャラカメラ(CharaCam_Front_Center_Mid, PID_ルイ, cam_anim_zoom_out_normal)\nキャラモーション再生(PID_ルイ, , EmoTalk,,1)\n*\nキャラモーション再生(PID_ルイ, Smile, IdleNormal)
MID_RELIANCE_C_#007	キャラカメラ(CharaCam_Side_Right3_Mid, PID_ユナカ, cam_anim_zoom_in_slow)\n*\nパペット会話中断()\nフェードアウト()\nサウンドイベント(SE_Reliance_Cup)\nウェイト(1.5)\nキャラ視線リセット(PID_ユナカ)\nキャラモーション再生(PID_ユナカ, Smile)
MID_RELIANCE_C_#008	キャラカメラ(CharaCam_Side_Right2_Top, PID_ユナカ, cam_anim_zoom_out_slow)\nキャラモーション再生(PID_ユナカ, , EmoShy)\nフェードイン()\n*\nキャラモーション再生(PID_ユナカ, Normal, IdleNormal,,1)
MID_RELIANCE_C_#009	キャラカメラ(CharaCam_FrontLong2_Left_Bot, PID_ルイ, cam_anim_pan_l_normal)\nキャラモーション再生(PID_ルイ, , EmoNod,,1)
MID_RELIANCE_C_#010	キャラモーション再生(PID_ルイ, , EmoTalk,,1)
MID_RELIANCE_C_#011	キャラカメラ(CharaCam_Side_Left2_Mid, PID_ルイ, cam_anim_track_r_normal)\nキャラ視線(PID_ユナカ, PID_ルイ, PID_ルイ)\n*\nキャラモーション再生(PID_ルイ, Normal, IdleNormal,,1)
MID_RELIANCE_C_#012	キャラカメラ(CharaCam_FrontLong2_Right_Top, PID_ユナカ, cam_anim_pan_r_normal)\nキャラモーション再生(PID_ユナカ, , EmoNod,,1)
MID_RELIANCE_C_#013	キャラモーション再生(PID_ユナカ, , EmoTalk,,1)\n*\nキャラモーション再生(PID_ユナカ, Surprise, IdleNormal)
MID_RELIANCE_C_#014	キャラカメラ(CharaCam_Side_Left3_Mid, PID_ルイ, cam_anim_track_l_normal)\nキャラモーション再生(PID_ルイ, , EmoThink,,1)\n\nキャラアニメーター切替(PID_ユナカ, Unit/Anim/Demo/AOC_Demo_Hum0F)\n*\nキャラモーション再生(PID_ルイ, Normal, IdleNormal)
MID_RELIANCE_C_#015	キャラカメラ(CharaCam_SideLong_Right2_Mid, PID_ユナカ, cam_anim_pan_u_slow)
MID_RELIANCE_C_#016	キャラモーション再生(PID_ユナカ, Sad, EmoThink,,0.5)\n*\nキャラモーション再生(PID_ユナカ, Normal, IdleNormal,,1)
MID_RELIANCE_C_#017	キャラカメラ(CharaCam_FrontLong2_Left_Bot, PID_ルイ, cam_anim_pan_l_normal)\nキャラモーション再生(PID_ルイ, , EmoThink,,1)
MID_RELIANCE_C_#018	キャラモーション再生(PID_ルイ, , EmoTalk,,1)\n*\nキャラモーション再生(PID_ルイ, Normal, IdleNormal,,1)
MID_RELIANCE_C_#019	キャラカメラ(CharaCam_FrontLong2_Right_Top, PID_ユナカ, cam_anim_pan_r_normal)\nキャラモーション再生(PID_ユナカ, , EmoDeny, 2, 1)\n*\nキャラモーション再生(PID_ユナカ, Smile, IdleNormal)
MID_RELIANCE_C_#020	キャラカメラ(CharaCam_Side_Left3_Mid, PID_ルイ, cam_anim_track_l_normal)\nキャラモーション再生(PID_ルイ, , EmoTalk2,,1)\n*\nキャラモーション再生(PID_ルイ, Normal, IdleNormal)
MID_RELIANCE_C_#021	キャラカメラ(CharaCam_Side_Right3_Top, PID_ユナカ, cam_anim_track_r_normal)\nキャラモーション再生(PID_ユナカ, , EmoTalk,,1)\n*\nキャラモーション再生(PID_ユナカ, Normal, IdleNormal)
MID_RELIANCE_C_#022	キャラカメラ(CharaCam_Side_Left2_Mid, PID_ルイ, cam_anim_zoom_in_slow)\nキャラモーション再生(PID_ルイ, , EmoNod,,1)\n*\nフェードアウト()
MID_RELIANCE_B_#001	キャラ配置(PID_ルイ, ME_IN_C,, Smile, IdleNormal, 90)\nキャラ配置(PID_ユナカ, YOU_IN_C,, Normal, IdleNormal)\n\n背景(Map_Event_Hub_Solanel_03_Day)\nライト(CharaLight_Hub_Day)\n\nキャラ視線(PID_ユナカ, PID_ルイ, PID_ルイ)\n\nシーンカメラ(SceneCam_SideMe_Right_Mid, cam_anim_zoom_in_normal)\nキャラモーション再生(PID_ユナカ, , RunIn)\nフェードイン()\n\nキャラ視線(PID_ルイ, PID_ユナカ, PID_ユナカ, 1)\n*\nキャラ視線(PID_ルイ, PID_ユナカ, PID_ユナカ)\nキャラモーション再生(PID_ユナカ, Shy, IdleNormal,,1)
MID_RELIANCE_B_#002	キャラカメラ(CharaCam_FrontLong2_Left_Bot, PID_ルイ, cam_anim_pan_l_normal)\nキャラ回転(PID_ルイ, -90, 1.2)\nキャラモーション再生(PID_ルイ, , TurnL,, 0.3)\nキャラモーション再生(PID_ルイ, , EmoTalk, 3, 0.3)\n*\nキャラモーション再生(PID_ルイ, Surprise, IdleNormal)\nキャラ表示切替(PID_ルイ, False)
MID_RELIANCE_B_#003	キャラカメラ(CharaCam_SideLong_Right2_Mid, PID_ユナカ, cam_anim_track3_r_normal)\nキャラモーション再生(PID_ユナカ, , EmoShy,,1)\n*\nキャラモーション再生(PID_ユナカ, Normal, IdleNormal,,1)
MID_RELIANCE_B_#004	キャラモーション再生(PID_ユナカ, , EmoGive, 3, 1)\n*\nキャラモーション再生(PID_ユナカ, Normal, IdleNormal)\nキャラ表示切替(PID_ルイ, True)
MID_RELIANCE_B_#005	キャラカメラ(CharaCam_Side_Left3_Mid, PID_ルイ, cam_anim_track_l_normal)\nキャラモーション再生(PID_ルイ, , EmoThinkIn,,1)\n*\nキャラモーション再生(PID_ルイ, Normal, IdleNormal,,1)
MID_RELIANCE_B_#006	キャラカメラ(CharaCam_FrontLong2_Right_Top, PID_ユナカ, cam_anim_pan_r_normal)\nキャラモーション再生(PID_ユナカ, , EmoNod,,1)
MID_RELIANCE_B_#007	キャラモーション再生(PID_ユナカ, , EmoTalk2,,1)
MID_RELIANCE_B_#008	キャラカメラ(CharaCam_Front_Center_Top, PID_ユナカ, cam_anim_zoom_out_normal)\nキャラモーション再生(PID_ユナカ, , EmoRelax,,1)\n*\nキャラ表示切替(PID_ユナカ, False)\nキャラモーション再生(PID_ユナカ, Normal, IdleNormal)
MID_RELIANCE_B_#009	キャラカメラ(CharaCam_SideLong_Left2_Mid, PID_ルイ, cam_anim_track3_l_normal)\nキャラモーション再生(PID_ルイ, , EmoRelax,,1)\n\nキャラアニメーター切替(PID_ユナカ, Unit/Anim/Demo/AOC_Demo_Hum0F)
MID_RELIANCE_B_#010	キャラモーション再生(PID_ルイ, , EmoTalk,,1)\n*\nキャラモーション再生(PID_ルイ, Normal, IdleNormal,,1)\nキャラ表示切替(PID_ユナカ, True)
MID_RELIANCE_B_#011	キャラカメラ(CharaCam_FrontLong2_Right_Top, PID_ユナカ, cam_anim_pan_r_normal)\nキャラモーション再生(PID_ユナカ, , EmoThink,,1)\n*\nキャラモーション再生(PID_ユナカ, Sad, IdleNormal,,1)
MID_RELIANCE_B_#012	キャラカメラ(CharaCam_FrontLong2_Left_Bot, PID_ルイ, cam_anim_pan_r_slow)\nキャラモーション再生(PID_ルイ, , EmoTalk2,,1)\n*\nキャラモーション再生(PID_ルイ, Surprise, IdleNormal)
MID_RELIANCE_B_#013	キャラカメラ(CharaCam_Side_Right3_Mid, PID_ユナカ, cam_anim_zoom_in_slow)
MID_RELIANCE_B_#014	キャラモーション再生(PID_ユナカ, , EmoDeny2,,1)\n*\nキャラモーション再生(PID_ユナカ, Surprise, IdleNormal)\nキャラ視線リセット(PID_ユナカ)
MID_RELIANCE_B_#015	キャラカメラ(CharaCam_Side_Left3_Mid, PID_ルイ, cam_anim_zoom_in_slow)\n*\nキャラモーション再生(PID_ルイ, Normal, IdleNormal,,1)
MID_RELIANCE_B_#016	キャラカメラ(CharaCam_SideLong_Right2_Mid, PID_ユナカ, cam_anim_track3_l_normal)
MID_RELIANCE_B_#017	キャラモーション再生(PID_ユナカ, Normal, EmoSad,,1)\n*\nキャラモーション再生(PID_ユナカ, Normal, IdleNormal)\nキャラ視線(PID_ユナカ, PID_ルイ, PID_ルイ)
MID_RELIANCE_B_#018	キャラカメラ(CharaCam_SideLong_Left2_Mid, PID_ルイ, cam_anim_pan_u_slow)\nキャラモーション再生(PID_ルイ, , EmoThinkIn,,1)\n\nキャラアニメーター切替(PID_ユナカ, Unit/Anim/Demo/AOC_Demo_c253)
MID_RELIANCE_B_#019	キャラモーション再生(PID_ルイ, , EmoTalk,,1)\n*\nキャラモーション再生(PID_ルイ, Normal, IdleNormal)
MID_RELIANCE_B_#020	キャラカメラ(CharaCam_Side_Right3_Top, PID_ユナカ, cam_anim_track_r_normal)\n*\nキャラモーション再生(PID_ユナカ, Relax, IdleNormal,,1)
MID_RELIANCE_B_#021	キャラカメラ(CharaCam_FrontLong2_Left_Bot, PID_ルイ, cam_anim_pan_l_normal)\nキャラモーション再生(PID_ルイ, , EmoTalk2,,1)\n*\nキャラモーション再生(PID_ルイ, Smile, IdleNormal)
MID_RELIANCE_B_#022	キャラカメラ(CharaCam_SideLong_Right2_Mid, PID_ユナカ, cam_anim_track3_l_normal)\nキャラモーション再生(PID_ユナカ, , EmoNod,,1)
MID_RELIANCE_B_#023	キャラモーション再生(PID_ユナカ, , EmoTalk,,1)\n*\nキャラモーション再生(PID_ユナカ, Normal, IdleNormal,,1)
MID_RELIANCE_B_#024	キャラカメラ(CharaCam_Side_Left3_Mid, PID_ルイ, cam_anim_zoom_in_slow)\nキャラモーション再生(PID_ルイ, , EmoNod,,1)\n*\nフェードアウト()
MID_RELIANCE_A_#001	キャラ配置(PID_ルイ, YOU_IN_C,, Normal, IdleNormal)\nキャラ配置(PID_ユナカ, ME_IN_C,, Surprise, IdleNormal)\n\n背景(Map_Event_Hub_Solanel_01_Day)\nライト(CharaLight_Hub_Day)\n\nキャラ視線(PID_ルイ, PID_ユナカ, PID_ユナカ)\nキャラ視線(PID_ユナカ, PID_ルイ, PID_ルイ)\n\nウェイト(0.4)\n\nキャラカメラ(CharaCam_Side_Right3_Top, PID_ユナカ, cam_anim_zoom_in_slow)\nフェードイン()
MID_RELIANCE_A_#002	キャラカメラ(CharaCam_FrontLong2_Left_Bot, PID_ルイ, cam_anim_track3_r_normal)\nキャラモーション再生(PID_ルイ, , EmoNod,,1)
MID_RELIANCE_A_#003	キャラモーション再生(PID_ルイ, , EmoTalk,,1)
MID_RELIANCE_A_#004	キャラカメラ(CharaCam_Side_Left2_Mid, PID_ルイ, cam_anim_track_r_normal)\nキャラモーション再生(PID_ルイ, , EmoJoy,,1)\n*\nキャラモーション再生(PID_ルイ, Normal, IdleNormal,,1)
MID_RELIANCE_A_#005	キャラカメラ(CharaCam_FrontLong2_Right_Top, PID_ユナカ, cam_anim_pan_r_normal)\nキャラモーション再生(PID_ユナカ, , EmoTalk,,1)\n*\nキャラモーション再生(PID_ユナカ, Normal, IdleNormal)
MID_RELIANCE_A_#006	キャラカメラ(CharaCam_SideLong_Left2_Mid, PID_ルイ, cam_anim_pan_u_slow)\nキャラモーション再生(PID_ルイ, , EmoTalk,,1)\n*\nキャラモーション再生(PID_ルイ, Smile, IdleNormal)
MID_RELIANCE_A_#007	キャラカメラ(CharaCam_Side_Right3_Mid, PID_ユナカ, cam_anim_track_r_normal)\nキャラモーション再生(PID_ユナカ, , EmoTalk2,,1)\n*\nキャラモーション再生(PID_ユナカ, Relax, IdleNormal,,1)
MID_RELIANCE_A_#008	キャラカメラ(CharaCam_FrontLong2_Left_Bot, PID_ルイ, cam_anim_pan_l_normal)\nキャラモーション再生(PID_ルイ, , EmoNod,,1)\n*\nキャラモーション再生(PID_ルイ, Surprise, IdleNormal)
MID_RELIANCE_A_#009	キャラカメラ(CharaCam_SideLong_Right2_Mid, PID_ユナカ, cam_anim_pan_u_slow)\nキャラモーション再生(PID_ユナカ, , EmoNod,,1)
MID_RELIANCE_A_#010	キャラモーション再生(PID_ユナカ, Sad, IdleNormal,,1)
MID_RELIANCE_A_#011	キャラカメラ(CharaCam_Side_Left3_Bot, PID_ルイ, cam_anim_zoom_in_slow)\n*\nキャラモーション再生(PID_ルイ, Normal, IdleNormal,,1)
MID_RELIANCE_A_#012	キャラカメラ(CharaCam_FrontLong2_Right_Top, PID_ユナカ, cam_anim_pan_r_normal)\nキャラモーション再生(PID_ユナカ, , EmoThink,,1)
MID_RELIANCE_A_#013	キャラモーション再生(PID_ユナカ, , EmoSad2,,1)\n*\nキャラモーション再生(PID_ユナカ, Sad, IdleNormal)\nキャラ視線リセット(PID_ユナカ)
MID_RELIANCE_A_#014	キャラカメラ(CharaCam_Side_Left3_Bot, PID_ルイ, cam_anim_zoom_in_slow)\nキャラモーション再生(PID_ルイ, , EmoNod,,1)\n\nキャラアニメーター切替(PID_ユナカ, Unit/Anim/Demo/AOC_Demo_Hum0F)\n*\nキャラモーション再生(PID_ルイ, Normal, IdleNormal)
MID_RELIANCE_A_#015	キャラカメラ(CharaCam_Side_Right3_Top, PID_ユナカ, cam_anim_track_r_normal)\nキャラモーション再生(PID_ユナカ, , EmoDeny2,,1)
MID_RELIANCE_A_#016	キャラモーション再生(PID_ユナカ, , EmoSad,,1)\n*\nキャラ表示切替(PID_ユナカ, False)\nキャラモーション再生(PID_ユナカ, Surprise, IdleNormal)\nキャラ視線(PID_ユナカ, PID_ルイ, PID_ルイ)
MID_RELIANCE_A_#017	キャラカメラ(CharaCam_SideLong_Left2_Mid, PID_ルイ, cam_anim_track3_l_normal)\n\nキャラアニメーター切替(PID_ユナカ, Unit/Anim/Demo/AOC_Demo_c253)
MID_RELIANCE_A_#018	キャラモーション再生(PID_ルイ, Smile, EmoJoy,,1)\n*\nキャラモーション再生(PID_ルイ, Normal, IdleNormal)\nキャラ表示切替(PID_ユナカ, True)
MID_RELIANCE_A_#019	キャラカメラ(CharaCam_Side_Right_Mid, PID_ユナカ, cam_anim_dolly_r_normal)\n*\nキャラモーション再生(PID_ユナカ, Smile, IdleNormal)
MID_RELIANCE_A_#020	キャラカメラ(CharaCam_FrontLong2_Left_Bot, PID_ルイ, cam_anim_track3_r_normal)\nキャラモーション再生(PID_ルイ, , EmoTalk2,,1)
MID_RELIANCE_A_#021	キャラモーション再生(PID_ルイ, , EmoNod,,1)
MID_RELIANCE_A_#022	キャラカメラ(CharaCam_Side_Left3_Mid, PID_ルイ, cam_anim_zoom_out_slow)\nキャラモーション再生(PID_ルイ, , EmoTalk,,1)\n*\nキャラモーション再生(PID_ルイ, Normal, IdleNormal)
MID_RELIANCE_A_#023	キャラカメラ(CharaCam_Side_Right3_Top, PID_ユナカ, cam_anim_zoom_in_slow)\n*\nキャラモーション再生(PID_ユナカ, Shy, IdleNormal,,1)
MID_RELIANCE_A_#024	キャラカメラ(CharaCam_FrontLong2_Left_Bot, PID_ルイ, cam_anim_pan_l_normal)\nキャラモーション再生(PID_ルイ, , EmoTalk2,,1)\n*\nキャラモーション再生(PID_ルイ, Normal, IdleNormal,,1)
MID_RELIANCE_A_#025	キャラカメラ(CharaCam_FrontLong2_Right_Top, PID_ユナカ, cam_anim_pan_l_slow)\nキャラモーション再生(PID_ユナカ, , EmoShy,,1)\n*\nキャラモーション再生(PID_ユナカ, Smile, IdleNormal,,1)
MID_RELIANCE_A_#026	キャラカメラ(CharaCam_FrontLong2_Left_Bot, PID_ルイ, cam_anim_pan_r_slow)\nキャラモーション再生(PID_ルイ, , EmoJoy,,1)
MID_RELIANCE_A_#027	
MID_RELIANCE_A_#028	キャラカメラ(CharaCam_Side_Left3_Bot, PID_ルイ, cam_anim_zoom_in_slow)\nキャラモーション再生(PID_ルイ, Smile, EmoTalk,,1)\n*\nキャラモーション再生(PID_ルイ, Normal, IdleNormal)
MID_RELIANCE_A_#029	キャラカメラ(CharaCam_Side_Right3_Top, PID_ユナカ, cam_anim_zoom_in_slow)\nキャラモーション再生(PID_ユナカ, , EmoNod,,1)\n*\nフェードアウト()
