MID_RELIANCE_C_#001	キャラ配置(PID_ルイ, ME_IN_C, [服装], Normal, IdleNormal, 0)\nキャラ配置(PID_クロエ, YOU_IN_C, [服装], Normal, IdleNormal, 0)\n\n背景(Map_Event_Hub_Solanel_01_Day)\nライト(CharaLight_Hub_Morning, 0, 0, 0)\n\nキャラ視線(PID_ルイ, PID_クロエ, PID_クロエ)\nキャラ視線(PID_クロエ, PID_ルイ, PID_ルイ)\n\nキャラモーション再生(PID_クロエ, Sad)\n\nウェイト(1.3)\n\nキャラカメラ(CharaCam_FrontLong2_Right_Top, PID_クロエ, cam_anim_zoom_in_normal)\n\nフェードイン()
MID_RELIANCE_C_#002	キャラモーション再生(PID_ルイ, Normal, EmoNod,, 0.3)\nキャラモーション再生(PID_ルイ, Normal, IdleNormal, 2, 1)\n\nキャラカメラ(CharaCam_Front_Center2_Mid, PID_ルイ, cam_anim_pan_d_slow)
MID_RELIANCE_C_#003	キャラモーション再生(PID_ルイ, Smile, IdleNormal,, 1)\nキャラモーション再生(PID_ルイ, Smile, EmoJoy, 3.8, 0.3)
MID_RELIANCE_C_#004	キャラモーション再生(PID_クロエ, Sad, EmoSad, 2, 0.3)\nキャラモーション再生(PID_ルイ, Smile, IdleNormal)\n\nキャラカメラ(CharaCam_Side_Right2_Mid, PID_クロエ, cam_anim_track_l_normal)
MID_RELIANCE_C_#005	キャラモーション再生(PID_ルイ, Die)\nキャラモーション再生(PID_ルイ, Die, EmoThink, 2.3, 0.3)\nキャラモーション再生(PID_クロエ, Sad, IdleNormal)\n\nキャラカメラ(CharaCam_Side_Left2_Mid, PID_ルイ, cam_anim_track_r_slow)
MID_RELIANCE_C_#006	キャラモーション再生(PID_ルイ, Die)
MID_RELIANCE_C_#007	キャラモーション再生(PID_クロエ, Normal)\nキャラモーション再生(PID_ルイ, Die, IdleNormal)\n\nキャラカメラ(CharaCam_Side_Right3_Mid, PID_クロエ, cam_anim_pan_d_normal)
MID_RELIANCE_C_#008	キャラモーション再生(PID_ルイ, Normal)\n\nキャラカメラ(CharaCam_Front_Center_Top, PID_ルイ, cam_anim_zoom_out_slow)
MID_RELIANCE_C_#009	キャラモーション再生(PID_ルイ, Normal, EmoTalk, 2, 0.3)
MID_RELIANCE_C_#010	キャラモーション再生(PID_クロエ, Sad, EmoNod,, 0.3)\nキャラモーション再生(PID_クロエ, Normal,, 3.5)\nキャラモーション再生(PID_ルイ, Normal, IdleNormal)\n\nキャラカメラ(CharaCam_Front_Center_Top, PID_クロエ, cam_anim_pan_u_normal)
MID_RELIANCE_C_#011	キャラモーション再生(PID_クロエ, Normal, IdleNormal)\n\nキャラカメラ(CharaCam_Side_Left2_Mid, PID_ルイ, cam_anim_track_r_normal)
MID_RELIANCE_C_#012	キャラモーション再生(PID_クロエ, Relax)\nキャラモーション再生(PID_クロエ, Smile, EmoJoy, 5.3, 1)\n\nキャラカメラ(CharaCam_Side_Right2_Mid, PID_クロエ, cam_anim_track_l_slow)
MID_RELIANCE_C_#013	キャラモーション再生(PID_クロエ, Smile)
MID_RELIANCE_C_#014	キャラモーション再生(PID_クロエ, Smile, IdleNormal)\n\nキャラカメラ(CharaCam_Side_Left3_Mid, PID_ルイ, cam_anim_pan_d_normal)
MID_RELIANCE_C_#015	キャラモーション再生(PID_ルイ, Relax, EmoTalk,, 0.3)\n\nキャラカメラ(CharaCam_Shoulder_Left_Mid, PID_クロエ, cam_anim_track2_l_normal)
MID_RELIANCE_C_#016	
MID_RELIANCE_C_#017	キャラモーション再生(PID_クロエ, Smile, EmoNod,, 0.3)\nキャラモーション再生(PID_ルイ, Relax, IdleNormal)\n\nキャラカメラ(CharaCam_Front_Center_Top, PID_クロエ, cam_anim_pan_u_normal)\n\n*\n\nフェードアウト()
MID_RELIANCE_B_#001	キャラ配置(PID_ルイ, YOU_IN_C, [服装], Normal, IdleNormal, 0)\nキャラ配置(PID_クロエ, ME_IN_C, [服装], Normal, IdleNormal, 0)\nキャラ配置(PID_デモ用_視線設定用, ME_IN_A, [服装], Normal, IdleNormal, 0)\n\nキャラ配置調整(PID_ルイ, 0, 0, -0.1, 50)\nキャラ配置調整(PID_クロエ, 0, 0, 0.1, -50)\nキャラ配置調整(PID_デモ用_視線設定用, -1, 0, 0.6, 0)\n\n背景(Map_Event_M004_03)\nライト(CharaLight_M001, 0, 0, 0)\n\nキャラ視線(PID_ルイ, PID_デモ用_視線設定用, PID_デモ用_視線設定用)\nキャラ視線(PID_クロエ, PID_デモ用_視線設定用, PID_デモ用_視線設定用)\n\nウェイト(1)\n\nキャラカメラ(CharaCam_Shoulder_Right_Top, PID_ルイ, cam_anim_pan_l_normal)\n\nフェードイン()
MID_RELIANCE_B_#002	キャラモーション再生(PID_クロエ, Normal)\n\nキャラカメラ(CharaCam_Side_Right2_Mid, PID_クロエ, cam_anim_zoom_in_slow)
MID_RELIANCE_B_#003	キャラモーション再生(PID_クロエ, Smile)\nキャラモーション再生(PID_クロエ, Smile, EmoJoy, 2.8, 1)
MID_RELIANCE_B_#004	キャラモーション再生(PID_ルイ, Normal, EmoNod)\nキャラモーション再生(PID_クロエ, Smile, IdleNormal)\n\nキャラカメラ(CharaCam_Side_Left2_Mid, PID_ルイ, cam_anim_zoom_in_slow)
MID_RELIANCE_B_#005	キャラモーション再生(PID_ルイ, Normal, IdleNormal,, 1)
MID_RELIANCE_B_#006	キャラモーション再生(PID_ルイ, Die)\n\nキャラ視線(PID_クロエ, PID_ルイ, PID_ルイ)
MID_RELIANCE_B_#007	キャラモーション再生(PID_クロエ, Normal)\nキャラモーション再生(PID_クロエ, Normal, EmoSad2, 2.4, 0.3)\n\nキャラカメラ(CharaCam_Shoulder_Right_Top, PID_ルイ, cam_anim_zoom_in_normal)
MID_RELIANCE_B_#008	キャラモーション再生(PID_クロエ, Normal, IdleNormal)\n\nキャラカメラ(CharaCam_Side_Left2_Mid, PID_ルイ, cam_anim_track_r_normal)
MID_RELIANCE_B_#009	キャラモーション再生(PID_クロエ, Smile)\nキャラモーション再生(PID_クロエ, Smile, EmoTalk, 0.8, 0.3)\n\nキャラ視線(PID_ルイ, PID_クロエ, PID_クロエ)\n\nキャラカメラ(CharaCam_Side_Right2_Mid, PID_クロエ, cam_anim_track_l_normal)
MID_RELIANCE_B_#010	キャラモーション再生(PID_ルイ, Die, EmoDeny2)\nキャラモーション再生(PID_クロエ, Smile, IdleNormal,, 1.5)\n\nキャラカメラ(CharaCam_Shoulder_Left_Mid, PID_クロエ, cam_anim_pan_u_slow)
MID_RELIANCE_B_#011	キャラモーション再生(PID_ルイ, Die, IdleNormal,, 1)
MID_RELIANCE_B_#012	キャラモーション再生(PID_クロエ, Normal, EmoThink,, 0.3)\n\nキャラカメラ(CharaCam_Side_Right2_Mid, PID_クロエ, cam_anim_track_l_normal)
MID_RELIANCE_B_#013	キャラモーション再生(PID_ルイ, Die, EmoTalk)\nキャラモーション再生(PID_クロエ, Normal, IdleNormal)\n\nキャラカメラ(CharaCam_Side_Left2_Mid, PID_ルイ, cam_anim_track_r_slow)
MID_RELIANCE_B_#014	キャラモーション再生(PID_ルイ, Normal,, 4.7)
MID_RELIANCE_B_#015	キャラモーション再生(PID_ルイ, Normal, IdleNormal,, 1)
MID_RELIANCE_B_#016	キャラモーション再生(PID_ルイ, Sad)\nキャラモーション再生(PID_ルイ, Sad, EmoSad, 3.7, 0.3)\n\nキャラカメラ(CharaCam_Shoulder_Left_Mid, PID_クロエ, cam_anim_track2_l_normal)
MID_RELIANCE_B_#017	キャラモーション再生(PID_クロエ, Relax, EmoRelax,, 0.3)\nキャラモーション再生(PID_ルイ, Sad, IdleNormal)\n\nキャラカメラ(CharaCam_Side_Right2_Top, PID_クロエ, cam_anim_pan_d_normal)
MID_RELIANCE_B_#018	キャラモーション再生(PID_クロエ, Normal, IdleNormal,, 1.5)\n\nキャラカメラ(CharaCam_Shoulder_Right_Top, PID_ルイ, cam_anim_zoom_in_slow)
MID_RELIANCE_B_#019	
MID_RELIANCE_B_#020	キャラモーション再生(PID_クロエ, Normal, EmoSad, 1.7, 0.3)
MID_RELIANCE_B_#021	キャラモーション再生(PID_ルイ, Relax)\nキャラモーション再生(PID_クロエ, Normal, IdleNormal)\n\nキャラカメラ(CharaCam_Side_Left2_Mid, PID_ルイ, cam_anim_pan_d_normal)
MID_RELIANCE_B_#022	キャラモーション再生(PID_クロエ, Normal, EmoTalk)\n\nキャラ視線(PID_クロエ, PID_デモ用_視線設定用, PID_ルイ, 2.7)\n\nシーンカメラ(SceneCam_Side_Left_Mid, cam_anim_zoom_out_slow)
MID_RELIANCE_B_#023	キャラモーション再生(PID_ルイ, Normal, EmoNod,, 0.3)\nキャラモーション再生(PID_クロエ, Normal, IdleNormal,, 1.5)\n\nキャラ視線(PID_クロエ, PID_ルイ, PID_ルイ)\n\n*\n\nフェードアウト()
MID_RELIANCE_A_#001	キャラ配置(PID_ルイ, ME_IN_C, [服装], Normal, IdleNormal, 0)\nキャラ配置(PID_クロエ, YOU_IN_C, [服装], Normal, IdleNormal, 0)\n\n背景(Map_Event_Hub_Solanel_03_Day)\nライト(CharaLight_M001, 0, 0, 0)\n\nキャラ視線(PID_ルイ, PID_クロエ, PID_クロエ)\nキャラ視線(PID_クロエ, PID_ルイ, PID_ルイ)\n\nウェイト(1)\n\nキャラモーション再生(PID_ルイ, Normal, EmoJoy, 3.4, 0.3)\n\nキャラカメラ(CharaCam_Shoulder_Left_Mid, PID_クロエ, cam_anim_track2_l_normal)\n\nフェードイン()
MID_RELIANCE_A_#002	キャラモーション再生(PID_クロエ, Relax, EmoNod,, 0.3)\nキャラモーション再生(PID_ルイ, Normal, IdleNormal)\n\nキャラカメラ(CharaCam_Front_Center_Top, PID_クロエ, cam_anim_pan_u_normal)
MID_RELIANCE_A_#003	キャラモーション再生(PID_ルイ, Normal, EmoGive)\nキャラモーション再生(PID_クロエ, Relax, IdleNormal)\n\nキャラカメラ(CharaCam_Side_Left_Mid, PID_ルイ, cam_anim_track_r_normal)
MID_RELIANCE_A_#004	キャラモーション再生(PID_クロエ, Normal, EmoThink)\nキャラモーション再生(PID_ルイ, Normal, IdleNormal)\n\nキャラカメラ(CharaCam_Side_Right2_Mid, PID_クロエ, cam_anim_track_l_slow)
MID_RELIANCE_A_#005	
MID_RELIANCE_A_#006	キャラモーション再生(PID_クロエ, Relax)
MID_RELIANCE_A_#007	キャラモーション再生(PID_クロエ, Relax, IdleNormal)\n\nキャラカメラ(CharaCam_Side_Left2_Mid, PID_ルイ, cam_anim_track_r_slow)
MID_RELIANCE_A_#008	キャラモーション再生(PID_ルイ, Normal, EmoTalk,, 0.3)
MID_RELIANCE_A_#009	キャラモーション再生(PID_クロエ, Smile)\nキャラモーション再生(PID_クロエ, Smile, EmoJoy, 1.8, 1)\nキャラモーション再生(PID_ルイ, Normal, IdleNormal)\n\nキャラカメラ(CharaCam_Front_Center_Top, PID_クロエ, cam_anim_zoom_out_slow)
MID_RELIANCE_A_#010	キャラモーション再生(PID_クロエ, Surprise, IdleNormal,, 1.5)
MID_RELIANCE_A_#011	キャラモーション再生(PID_ルイ, Relax)\nキャラモーション再生(PID_クロエ, Surprise,, IdleNormal)\n\nキャラカメラ(CharaCam_Front_Center2_Mid, PID_ルイ, cam_anim_pan_d_normal)
MID_RELIANCE_A_#012	キャラモーション再生(PID_クロエ, Relax)\n\nキャラカメラ(CharaCam_Side_Right2_Mid, PID_クロエ, cam_anim_track_l_slow)
MID_RELIANCE_A_#013	キャラモーション再生(PID_クロエ, Normal)\nキャラモーション再生(PID_クロエ, Normal, EmoSad2, 0.6, 0.3)
MID_RELIANCE_A_#014	キャラモーション再生(PID_ルイ, Die)\nキャラモーション再生(PID_クロエ, Normal, IdleNormal)\n\nキャラカメラ(CharaCam_Side_Left2_Mid, PID_ルイ, cam_anim_track_r_normal)
MID_RELIANCE_A_#015	キャラモーション再生(PID_クロエ, Smile, EmoGive,, 0.3)\n\nキャラカメラ(CharaCam_Side_Right_Mid, PID_クロエ, cam_anim_track_l_normal)
MID_RELIANCE_A_#016	キャラモーション再生(PID_ルイ, Smile)\nキャラモーション再生(PID_クロエ, Smile, IdleNormal)\n\nキャラカメラ(CharaCam_Front_Center2_Mid, PID_ルイ, cam_anim_pan_d_normal)
MID_RELIANCE_A_#017	キャラモーション再生(PID_クロエ, Normal, EmoNod,, 0.3)\n\nキャラカメラ(CharaCam_Side_Right2_Mid, PID_クロエ, cam_anim_track_l_normal)
MID_RELIANCE_A_#018	キャラモーション再生(PID_ルイ, Die, EmoThink)\nキャラモーション再生(PID_クロエ, Normal, IdleNormal)\n\nキャラカメラ(CharaCam_Side_Left2_Mid, PID_ルイ, cam_anim_track_r_normal)
MID_RELIANCE_A_#019	キャラモーション再生(PID_ルイ, Die, IdleNormal)\n\nキャラカメラ(CharaCam_Front_Center_Top, PID_クロエ, cam_anim_pan_u_slow)
MID_RELIANCE_A_#020	キャラモーション再生(PID_クロエ, Normal, EmoTalk,, 0.3)
MID_RELIANCE_A_#021	キャラモーション再生(PID_ルイ, Smile)\nキャラモーション再生(PID_クロエ, Normal, IdleNormal)\n\nキャラカメラ(CharaCam_Side_Left2_Top, PID_ルイ, cam_anim_zoom_in_normal)
MID_RELIANCE_A_#022	キャラモーション再生(PID_クロエ, Relax, EmoSad2, 4.4, 0.3)\n\nキャラカメラ(CharaCam_FrontLong2_Right_Top, PID_クロエ, cam_anim_zoom_in_normal)
MID_RELIANCE_A_#023	キャラモーション再生(PID_ルイ, Normal)\nキャラモーション再生(PID_クロエ, Relax, IdleNormal)\n\nキャラカメラ(CharaCam_Side_Left2_Mid, PID_ルイ, cam_anim_track_r_normal)
MID_RELIANCE_A_#024	キャラモーション再生(PID_ルイ, Normal, EmoDeny2, 3.5, 0.3)
MID_RELIANCE_A_#025	キャラモーション再生(PID_クロエ, Relax, EmoProud, 1.6, 0.3)\nキャラモーション再生(PID_ルイ, Normal, IdleNormal)\n\nキャラカメラ(CharaCam_Side_Right2_Mid, PID_クロエ, cam_anim_track_l_normal)
MID_RELIANCE_A_#026	キャラモーション再生(PID_ルイ, Relax)\nキャラモーション再生(PID_クロエ, Relax, IdleNormal)\n\nキャラカメラ(CharaCam_Side_Left3_Mid, PID_ルイ, cam_anim_pan_d_normal)
MID_RELIANCE_A_#027	キャラモーション再生(PID_クロエ, Smile)\n\nキャラカメラ(CharaCam_Front_Center2_Mid, PID_クロエ, cam_anim_zoom_in_normal)
MID_RELIANCE_A_#028	キャラモーション再生(PID_ルイ, Smile, EmoNod)\nキャラモーション再生(PID_クロエ, Smile, IdleNormal)\n\nキャラカメラ(CharaCam_Front_Center2_Mid, PID_ルイ, cam_anim_zoom_in_normal)\n\n*\n\nフェードアウト()
