MID_RELIANCE_C_#001	キャラ配置(PID_リュール, ME_IN_C, [服装], Normal, IdleNormal, 0)\nキャラ配置(PID_ジャン, YOU_IN_C, [服装], Normal, IdleNormal, 0)\nキャラ配置調整(PID_ジャン, 0, 0, 0, -170)\n\n背景(Map_Event_M004_03)\nライト(CharaLight_Hub_Day, 0, 0, 0)\n\nキャラ視線(PID_リュール, PID_ジャン, PID_ジャン)\n\nキャラモーション再生(PID_ジャン, Smile, EmoTired)\nウェイト(0.5)\n\nキャラモーション再生(PID_リュール, Normal, WalkIn2)\nウェイト(0.8)\n\nキャラカメラ(CharaCam_Shoulder_Left_Mid, PID_ジャン, cam_anim_pan_u_slow)\n\nフェードイン()\n*\nパペット会話中断()\nキャラモーション待ち(PID_ジャン)\nキャラモーション再生(PID_ジャン, Smile, TurnR,, 0.3)\nキャラ回転(PID_ジャン, 170, 1.8)\nキャラ視線(PID_ジャン, PID_リュール, PID_リュール)\n\nウェイト(1.3)
MID_RELIANCE_C_#002	キャラモーション再生(PID_ジャン, Smile, EmoTalk2,, 1)\n\nキャラカメラ(CharaCam_Side_Right2_Mid, PID_ジャン, cam_anim_track_l_normal)
MID_RELIANCE_C_#003	キャラモーション再生(PID_リュール, Smile)\nキャラモーション再生(PID_ジャン, Smile, IdleNormal)\n\nキャラ視線リセット(PID_ジャン)\n\nキャラカメラ(CharaCam_Side_Left2_Mid, PID_リュール, cam_anim_track_r_normal)
MID_RELIANCE_C_#004	キャラモーション再生(PID_ジャン, Smile, EmoShy, 2, 0.3)\n\nキャラ視線(PID_ジャン, PID_リュール, PID_リュール, 5)\n\nキャラカメラ(CharaCam_Front_Center_Top, PID_ジャン, cam_anim_pan_u_slow)
MID_RELIANCE_C_#005	キャラモーション再生(PID_ジャン, Sad, IdleNormal,, 1)\n\nキャラ視線(PID_ジャン, PID_リュール, PID_リュール)
MID_RELIANCE_C_#006	キャラモーション再生(PID_ジャン, Relax)\n\nキャラカメラ(CharaCam_Shoulder_Right_Top, PID_リュール, cam_anim_zoom_in_normal)
MID_RELIANCE_C_#007	キャラカメラ(CharaCam_Front_Center2_Mid, PID_リュール, cam_anim_pan_d_slow)
MID_RELIANCE_C_#008	キャラモーション再生(PID_リュール, Smile, EmoTalk,, 0.3)
MID_RELIANCE_C_#009	キャラモーション再生(PID_ジャン, Surprise, EmoDeny,, 1)\nキャラモーション再生(PID_リュール, Smile, IdleNormal)\n\nキャラカメラ(CharaCam_Side_Right2_Mid, PID_ジャン, cam_anim_track_l_normal)
MID_RELIANCE_C_#010	キャラモーション再生(PID_ジャン, Surprise, IdleNormal)\n\nキャラカメラ(CharaCam_Side_Left3_Mid, PID_リュール, cam_anim_pan_d_slow)
MID_RELIANCE_C_#011	キャラモーション再生(PID_リュール, Shy, EmoThink,, 0.3)
MID_RELIANCE_C_#012	キャラモーション再生(PID_ジャン, Shy, EmoSad2)\nキャラモーション再生(PID_リュール, Relax, IdleNormal)\n\nキャラカメラ(CharaCam_Side_Right2_Mid, PID_ジャン, cam_anim_track_l_normal)
MID_RELIANCE_C_#013	キャラモーション再生(PID_リュール, Smile)\nキャラモーション再生(PID_ジャン, Shy, IdleNormal)\n\nキャラカメラ(CharaCam_Side_Left2_Mid, PID_リュール, cam_anim_track_r_normal)
MID_RELIANCE_C_#014	キャラモーション再生(PID_ジャン, Smile, EmoRelax)\n\nキャラカメラ(CharaCam_Front_Center2_Mid, PID_ジャン, cam_anim_pan_d_normal)\n\n*\n\nフェードアウト()
MID_RELIANCE_B_#001	キャラ配置(PID_リュール, ME_IN_C, [服装], Normal, IdleNormal, 0)\nキャラ配置(PID_ジャン, YOU_IN_C, [服装], Normal, IdleNormal, 0)\n\n背景(Map_Event_M004_03)\nライト(CharaLight_Hub_Day, 0, 0, 0)\n\nキャラ視線(PID_リュール, PID_ジャン, PID_ジャン)\nキャラ視線(PID_ジャン, PID_リュール, PID_リュール)\n\nウェイト(1)\n\nキャラモーション再生(PID_リュール, Smile, EmoTalk)\n\nキャラカメラ(CharaCam_Shoulder_Left_Bot, PID_ジャン, cam_anim_track2_l_normal)\n\nフェードイン()
MID_RELIANCE_B_#002	キャラモーション再生(PID_ジャン, Normal, EmoNod,, 0.3)\nキャラモーション再生(PID_リュール, Smile, IdleNormal)\n\nキャラカメラ(CharaCam_Side_Right2_Mid, PID_ジャン, cam_anim_track_l_slow)
MID_RELIANCE_B_#003	キャラモーション再生(PID_ジャン, Die, EmoThink,, 1)
MID_RELIANCE_B_#004	キャラモーション再生(PID_リュール, Normal, EmoThink)\nキャラモーション再生(PID_ジャン, Die, IdleNormal)\n\nキャラカメラ(CharaCam_Side_Left2_Mid, PID_リュール, cam_anim_track_r_normal)
MID_RELIANCE_B_#005	キャラモーション再生(PID_ジャン, Smile)\nキャラモーション再生(PID_リュール, Normal, IdleNormal)\n\nキャラカメラ(CharaCam_Front_Center_Top, PID_ジャン, cam_anim_zoom_out_slow)
MID_RELIANCE_B_#006	キャラモーション再生(PID_ジャン, Sad, EmoSad2,, 0.3)
MID_RELIANCE_B_#007	キャラモーション再生(PID_リュール, Shy)\nキャラモーション再生(PID_ジャン, Sad, IdleNormal)\n\nキャラカメラ(CharaCam_Side_Left2_Mid, PID_リュール, cam_anim_track_r_normal)
MID_RELIANCE_B_#008	キャラモーション再生(PID_ジャン, Shy)\n\nキャラカメラ(CharaCam_Side_Right2_Mid, PID_ジャン, cam_anim_track_l_normal)
MID_RELIANCE_B_#009	キャラモーション再生(PID_ジャン, Normal, EmoTalk2)\n\nキャラカメラ(CharaCam_Shoulder_Right_Top, PID_リュール, cam_anim_zoom_in_slow)
MID_RELIANCE_B_#010	キャラモーション再生(PID_ジャン, Die)
MID_RELIANCE_B_#011	キャラモーション再生(PID_ジャン, Relax)\n\nキャラカメラ(CharaCam_Front_Center_Top, PID_ジャン, cam_anim_pan_u_slow)
MID_RELIANCE_B_#012	キャラモーション再生(PID_ジャン, Relax, EmoRelax,, 1)
MID_RELIANCE_B_#013	キャラモーション再生(PID_リュール, Shy, EmoPray)\nキャラモーション再生(PID_ジャン, Smile, IdleNormal)\n\nキャラカメラ(CharaCam_Front_Center2_Mid, PID_リュール, cam_anim_pan_d_normal)
MID_RELIANCE_B_#014	キャラモーション再生(PID_ジャン, Surprise, EmoSurprise)\nキャラモーション再生(PID_リュール, Die, IdleNormal)\n\nキャラカメラ(CharaCam_Side_Right2_Mid, PID_ジャン, cam_anim_track_l_normal)
MID_RELIANCE_B_#015	キャラモーション再生(PID_リュール, Shy, EmoRelax)\nキャラモーション再生(PID_ジャン, Surprise, IdleNormal)\n\nキャラカメラ(CharaCam_Side_Left2_Top, PID_リュール, cam_anim_zoom_in_normal)
MID_RELIANCE_B_#016	キャラモーション再生(PID_ジャン, Smile)\nキャラモーション再生(PID_リュール, Shy, IdleNormal)\n\nキャラカメラ(CharaCam_Front_Center_Top, PID_ジャン, cam_anim_zoom_out_slow)
MID_RELIANCE_B_#017	キャラモーション再生(PID_ジャン, Smile, EmoGive,, 0.3)
MID_RELIANCE_B_#018	キャラカメラ(CharaCam_Side_Left3_Mid, PID_リュール, cam_anim_pan_d_normal)\n\n*\n\nフェードアウト()
MID_RELIANCE_A_#001	キャラ配置(PID_リュール, ME_IN_C, [服装], Normal, IdleNormal, 0)\nキャラ配置(PID_ジャン, YOU_IN_C, [服装], Normal, IdleNormal, 0)\nキャラ配置(PID_デモ用_視線設定用, ME_MID_C, [服装], Normal, IdleNormal, 0)\nキャラ配置(PID_デモ用_視線設定用2, YOU_IN_B, [服装], Normal, IdleNormal, 0)\n\nキャラ配置調整(PID_デモ用_視線設定用, 0, -1, 0, 0)\nキャラ配置調整(PID_デモ用_視線設定用2, 0, -1, 0, 0)\n\n背景(Map_Event_Hub_Solanel_01_Evening)\nライト(CharaLight_Hub_Evening, 0, 0, 0)\n\nキャラ視線(PID_リュール, PID_ジャン, PID_ジャン)\nキャラ視線(PID_ジャン, PID_リュール, PID_リュール)\n\nウェイト(1)\n\nキャラモーション再生(PID_リュール, Smile, EmoGive)\n\nキャラカメラ(CharaCam_FrontLong2_Left_Bot, PID_リュール, cam_anim_track_r_normal)\n\nフェードイン()
MID_RELIANCE_A_#002	キャラモーション再生(PID_ジャン, Surprise)\nキャラモーション再生(PID_リュール, Smile, IdleNormal)\n\nキャラカメラ(CharaCam_Front_Center_Top, PID_ジャン, cam_anim_pan_u_normal)
MID_RELIANCE_A_#003	キャラカメラ(CharaCam_Side_Left2_Mid, PID_リュール, cam_anim_track_r_normal)
MID_RELIANCE_A_#004	キャラモーション再生(PID_ジャン, Smile, EmoRelax)\n\nキャラカメラ(CharaCam_Side_Right2_Mid, PID_ジャン, cam_anim_track_l_normal)
MID_RELIANCE_A_#005	キャラモーション再生(PID_リュール, Smile, EmoTalk)\nキャラモーション再生(PID_ジャン, Smile, IdleNormal)\n\nキャラカメラ(CharaCam_Side_Left3_Mid, PID_リュール, cam_anim_pan_d_normal)
MID_RELIANCE_A_#006	キャラモーション再生(PID_リュール, Smile, IdleNormal)\n\nキャラカメラ(CharaCam_Front_Center_Mid, PID_ジャン, cam_anim_zoom_out_slow)
MID_RELIANCE_A_#007	キャラモーション再生(PID_ジャン, Surprise)\n\nキャラ視線(PID_ジャン, PID_デモ用_視線設定用, PID_リュール)
MID_RELIANCE_A_#008	キャラモーション再生(PID_リュール, Normal, EmoTalk2)\n\nキャラ視線(PID_リュール, PID_デモ用_視線設定用2, PID_ジャン)\nキャラ視線(PID_ジャン, PID_リュール, PID_リュール)\n\nキャラカメラ(CharaCam_Front_Center_Mid, PID_リュール, cam_anim_zoom_in_normal)
MID_RELIANCE_A_#009	キャラモーション再生(PID_ジャン, Sad)\nキャラモーション再生(PID_ジャン, Normal, EmoTalk, 1.5, 1)\nキャラモーション再生(PID_リュール, Normal, IdleNormal)\n\nキャラ視線(PID_リュール, PID_ジャン, PID_ジャン)\n\nキャラカメラ(CharaCam_Side_Right2_Mid, PID_ジャン, cam_anim_track_l_normal)
MID_RELIANCE_A_#010	キャラモーション再生(PID_リュール, Smile, EmoDeny2)\nキャラモーション再生(PID_ジャン, Normal, IdleNormal)\n\nキャラカメラ(CharaCam_Side_Left2_Mid, PID_リュール, cam_anim_track_r_normal)
MID_RELIANCE_A_#011	キャラモーション再生(PID_ジャン, Normal, EmoDeny,, 1)\nキャラモーション再生(PID_リュール, Smile, IdleNormal,, 1)\n\nキャラカメラ(CharaCam_Shoulder_Right_Top, PID_リュール, cam_anim_zoom_in_normal)
MID_RELIANCE_A_#012	キャラモーション再生(PID_リュール, Shy)\nキャラモーション再生(PID_ジャン, Normal, IdleNormal)\n\nキャラ視線(PID_ジャン, PID_デモ用_視線設定用, PID_デモ用_視線設定用)\n\nキャラカメラ(CharaCam_Front_Center_Top, PID_リュール, cam_anim_pan_u_normal)\n\n*\n\nパペット会話中断()\n\nフェードアウト()
MID_RELIANCE_A_#013	キャラモーション再生(PID_リュール, Normal)\n\nウェイト(0.5)\n\nスプリットビュー作成(SplitViewTestL, RenderTextureSampleL)\nスプリットビュー作成(SplitViewTestR, RenderTextureSampleR)\nスプリットビューキャラカメラ(SplitViewTestL, CharaCam_SplitView_Left_Mid, PID_リュール, cam_anim_pan_u_slow)\nスプリットビューキャラカメラ(SplitViewTestR, CharaCam_SplitView_Right_Mid, PID_ジャン, cam_anim_pan_u_slow)\nスプリットビューアニメ再生(SplitViewTestL, splitview_anim_L_in_fast)\nスプリットビューアニメ再生(SplitViewTestR, splitview_anim_R_in_fast)\nスプリットビューアニメ待ち(SplitViewTestL)\nスプリットビューアニメ待ち(SplitViewTestR)\n\nスプリットビューアクティブ(SplitViewTestL, False)\nスプリットビューアクティブ(SplitViewTestR, True)\n\nフェードイン()
MID_RELIANCE_A_#014	
MID_RELIANCE_A_#015	スプリットビューアクティブ(SplitViewTestL, True)\nスプリットビューアクティブ(SplitViewTestR, False)\n\nキャラモーション再生(PID_リュール, Surprise)
MID_RELIANCE_A_#016	スプリットビューアクティブ(SplitViewTestL, False)\nスプリットビューアクティブ(SplitViewTestR, True)\n\nキャラモーション再生(PID_ジャン, Die)
MID_RELIANCE_A_#017	キャラモーション再生(PID_ジャン, Strike)\nキャラモーション再生(PID_リュール, Normal)
MID_RELIANCE_A_#018	キャラモーション再生(PID_ジャン, Strike, EmoRelax,, 0.3)\n\nキャラ視線(PID_ジャン, PID_リュール, PID_リュール)
MID_RELIANCE_A_#019	スプリットビューアクティブ(SplitViewTestL, True)\nスプリットビューアクティブ(SplitViewTestR, False)\n\n*\n\nパペット会話中断()\n\nフェードアウト
MID_RELIANCE_A_#020	スプリットビューアニメ再生(SplitViewTestL, splitview_anim_L_out_fast)\nスプリットビューアニメ再生(SplitViewTestR, splitview_anim_R_out_fast)\nスプリットビューアニメ待ち(SplitViewTestL)\nスプリットビューアニメ待ち(SplitViewTestR)\n\nウェイト(0.4)\n\nキャラモーション再生(PID_ジャン, Smile, EmoTalk2)\n\nキャラカメラ(CharaCam_Front_Center_Top, PID_ジャン, cam_anim_pan_u_normal)\n\nフェードイン()
MID_RELIANCE_A_#021	キャラモーション再生(PID_リュール, Smile, EmoRelax)\nキャラモーション再生(PID_ジャン, Smile, IdleNormal)\n\nキャラカメラ(CharaCam_Front_Center_Mid, PID_リュール, cam_anim_pan_d_normal)\n\n*\n\nフェードアウト()
MID_RELIANCE_S_#001	キャラ配置(PID_リュール, ME_IN_C, [服装], Normal, IdleNormal, 0)\nキャラ配置(PID_ジャン, YOU_IN_C, [服装], Normal, IdleNormal, 0)\nキャラ配置(PID_デモ用_視線設定用, YOU_IN_B, [服装], Normal, IdleNormal, 0)\n\nキャラ配置調整(PID_デモ用_視線設定用, 0, -1, 0, 0)\n\n背景(Map_Event_M004_03)\nライト(CharaLight_Hub_Day, 0, 0, 0)\n\nキャラ視線(PID_リュール, PID_ジャン, PID_ジャン)\nキャラ視線(PID_ジャン, PID_リュール, PID_リュール)\n\nウェイト(1)\n\nキャラモーション再生(PID_リュール, Smile, EmoJoy)\n\nキャラカメラ(CharaCam_Shoulder_Left_Bot, PID_ジャン, cam_anim_track2_l_normal)\n\nフェードイン()
MID_RELIANCE_S_#002	キャラモーション再生(PID_ジャン, Smile)\nキャラモーション再生(PID_ジャン, Smile, EmoTalk2, 1.5, 0.3)\nキャラモーション再生(PID_リュール, Smile, IdleNormal)\n\nキャラカメラ(CharaCam_Side_Right2_Mid, PID_ジャン, cam_anim_track_l_normal)
MID_RELIANCE_S_#003	キャラモーション再生(PID_リュール, Smile, EmoDeny2)\nキャラモーション再生(PID_ジャン, Smile, IdleNormal)\n\nキャラカメラ(CharaCam_Side_Left2_Mid, PID_リュール, cam_anim_track_r_normal)
MID_RELIANCE_S_#004	キャラモーション再生(PID_ジャン, Surprise)\nキャラモーション再生(PID_リュール, Smile, IdleNormal,, 1)\n\nキャラカメラ(CharaCam_Shoulder_Right_Top, PID_リュール, cam_anim_zoom_in_normal)
MID_RELIANCE_S_#005	キャラモーション再生(PID_リュール, Normal, EmoTalk2,, 0.3)\n\nキャラ視線(PID_リュール, PID_デモ用_視線設定用, PID_ジャン)\n\nキャラカメラ(CharaCam_Front_Center_Mid, PID_リュール, cam_anim_zoom_in_slow)
MID_RELIANCE_S_#006	
MID_RELIANCE_S_#007	キャラモーション再生(PID_ジャン, Normal, EmoGive)\nキャラモーション再生(PID_リュール, Normal, IdleNormal)\n\nキャラ視線(PID_リュール, PID_ジャン, PID_ジャン)\n\nキャラカメラ(CharaCam_Side_Right2_Mid, PID_ジャン, cam_anim_track_l_slow)
MID_RELIANCE_S_#008	
MID_RELIANCE_S_#009	キャラモーション再生(PID_リュール, Smile)\nキャラモーション再生(PID_ジャン, Normal, IdleNormal)\n\nキャラカメラ(CharaCam_Side_Left2_Mid, PID_リュール, cam_anim_track_r_normal)
MID_RELIANCE_S_#010	キャラモーション再生(PID_ジャン, Strike)\n\nキャラカメラ(CharaCam_Side_Right3_Mid, PID_ジャン, cam_anim_pan_d_slow)
MID_RELIANCE_S_#011	キャラモーション再生(PID_ジャン, Strike, EmoRelax,, 0.3)
MID_RELIANCE_S_#012	キャラモーション再生(PID_リュール, Normal)\nキャラモーション再生(PID_ジャン, Strike, IdleNormal)\n\nキャラカメラ(CharaCam_Front_Center_Mid, PID_リュール, cam_anim_zoom_out_slow)
MID_RELIANCE_S_#013	キャラモーション再生(PID_リュール, Smile)
MID_RELIANCE_S_#014	キャラモーション再生(PID_ジャン, Surprise)\n\nキャラカメラ(CharaCam_Front_Center_Top, PID_ジャン, cam_anim_pan_u_normal)
MID_RELIANCE_S_#015	キャラカメラ(CharaCam_Side_Left_Mid, PID_リュール, cam_anim_track_r_slow)
MID_RELIANCE_S_#016	キャラモーション再生(PID_リュール, Smile, EmoGive,, 0.3)\n\n一枚絵表示(Tex_Event_ItemPicture_14, picture_item_fade_in_normal)\n\n*\n\nパペット会話中断()\n\nウェイト(1)\n\n一枚絵非表示(picture_item_fade_out_normal)\n\nウェイト(1)
MID_RELIANCE_S_#017	キャラモーション再生(PID_ジャン, Surprise, EmoDeny,, 1)\nキャラモーション再生(PID_リュール, Smile, IdleNormal)\n\nキャラカメラ(CharaCam_Side_Right2_Mid, PID_ジャン, cam_anim_track_l_normal)
MID_RELIANCE_S_#018	キャラモーション再生(PID_ジャン, Surprise, IdleNormal)\nキャラモーション再生(PID_リュール, Smile, EmoDeny2)\n\nキャラカメラ(CharaCam_Side_Left2_Mid, PID_リュール, cam_anim_track_r_normal)
MID_RELIANCE_S_#019	キャラモーション再生(PID_ジャン, Die)\nキャラモーション再生(PID_ジャン, Smile,, 2)\nキャラモーション再生(PID_リュール, Smile, IdleNormal,, 1)\n\nキャラカメラ(CharaCam_Shoulder_Right_Top, PID_リュール, cam_anim_zoom_in_slow)
MID_RELIANCE_S_#020	キャラモーション再生(PID_ジャン, Smile, EmoRelax,, 0.3)
MID_RELIANCE_S_#021	キャラモーション再生(PID_ジャン, Smile, IdleNormal)\n\nキャラカメラ(CharaCam_Side_Left2_Mid, PID_リュール, cam_anim_track_r_normal)
MID_RELIANCE_S_#022	キャラモーション再生(PID_ジャン, Strike, EmoJoy,, 1)\n\nキャラカメラ(CharaCam_Side_Right2_Top, PID_ジャン, cam_anim_track_l_slow)
MID_RELIANCE_S_#023	
MID_RELIANCE_S_#024	キャラモーション再生(PID_リュール, Shy, EmoRelax)\nキャラモーション再生(PID_ジャン, Strike, IdleNormal)\n\nキャラカメラ(CharaCam_Side_Left3_Mid, PID_リュール, cam_anim_pan_d_normal)
MID_RELIANCE_S_#025	キャラモーション再生(PID_ジャン, Shy, EmoNod)\nキャラモーション再生(PID_リュール, Shy, IdleNormal)\n\nキャラカメラ(CharaCam_Front_Center_Top, PID_ジャン, cam_anim_pan_u_normal)\n\n*\n\nパペット会話中断()
MID_RELIANCE_S_#026	フェードアウト()\n一枚絵表示(Tex_Event_Reliance_S_29)\nウェイト(0.8)\n\nフェードイン()\nウェイト(1.2)\n\n*\n\nウェイト(1)\nフェードアウト()
