MID_RELIANCE_C_#001	キャラ配置(PID_リュール, ME_IN_C, [服装], Normal, IdleNormal, 0)\nキャラ配置(PID_フォガート, YOU_IN_C, [服装], Normal, IdleNormal, 0)\n\n背景(Map_Event_M013_04)\nライト(CharaLight_Hub_Night, 0, 0, 0)\n\nキャラ視線(PID_リュール, PID_フォガート, PID_フォガート)\nキャラ視線(PID_フォガート, PID_リュール, PID_リュール)\n\nウェイト(1)\n\nキャラモーション再生(PID_リュール, Smile, EmoTalk)\n\nキャラカメラ(CharaCam_Shoulder_Left_Top, PID_フォガート, cam_anim_track2_l_normal)\n\nフェードイン()
MID_RELIANCE_C_#002	キャラモーション再生(PID_フォガート, Smile, EmoTalk2,, 0.3)\nキャラモーション再生(PID_リュール, Smile, IdleNormal)\n\nキャラカメラ(CharaCam_Side_Right3_Mid, PID_フォガート, cam_anim_pan_d_slow)
MID_RELIANCE_C_#003	
MID_RELIANCE_C_#004	キャラモーション再生(PID_フォガート, Relax)\n\nキャラカメラ(CharaCam_Shoulder_Right_Mid, PID_リュール, cam_anim_track2_r_normal)
MID_RELIANCE_C_#005	キャラモーション再生(PID_フォガート, Relax, IdleNormal)\n\nキャラカメラ(CharaCam_Side_Left3_Mid, PID_リュール, cam_anim_pan_d_slow)
MID_RELIANCE_C_#006	キャラモーション再生(PID_リュール, Smile, EmoRelax,, 0.3)
MID_RELIANCE_C_#007	キャラモーション再生(PID_フォガート, Shy, EmoShy,, 0.3)\nキャラモーション再生(PID_リュール, Smile, IdleNormal)\n\nキャラカメラ(CharaCam_Front_Center_Top, PID_フォガート, cam_anim_pan_u_slow)
MID_RELIANCE_C_#008	キャラモーション再生(PID_フォガート, Smile)
MID_RELIANCE_C_#009	キャラモーション再生(PID_リュール, Normal)\nキャラモーション再生(PID_フォガート, Smile, IdleNormal)\n\nキャラカメラ(CharaCam_Front_Center2_Mid, PID_リュール, cam_anim_pan_d_normal)
MID_RELIANCE_C_#010	キャラモーション再生(PID_フォガート, Smile, EmoTalk)\n\nキャラカメラ(CharaCam_Shoulder_Right_Mid, PID_リュール, cam_anim_zoom_in_normal)
MID_RELIANCE_C_#011	キャラモーション再生(PID_リュール, Sad)\nキャラモーション再生(PID_フォガート, Smile, IdleNormal)\n\nキャラカメラ(CharaCam_Side_Left2_Mid, PID_リュール, cam_anim_track_r_normal)
MID_RELIANCE_C_#012	キャラモーション再生(PID_フォガート, Relax, EmoThink,, 0.3)\n\nキャラカメラ(CharaCam_Side_Right2_Mid, PID_フォガート, cam_anim_track_l_normal)
MID_RELIANCE_C_#013	キャラモーション再生(PID_リュール, Sad, EmoDeny2)\nキャラモーション再生(PID_フォガート, Relax, IdleNormal)\n\nキャラカメラ(CharaCam_Front_Center_Mid, PID_リュール, cam_anim_zoom_out_slow)
MID_RELIANCE_C_#014	
MID_RELIANCE_C_#015	キャラモーション再生(PID_フォガート, Normal, EmoTalk2,, 0.3)\nキャラモーション再生(PID_リュール, Sad, IdleNormal)\n\nキャラカメラ(CharaCam_Side_Right3_Mid, PID_フォガート, cam_anim_pan_d_slow)
MID_RELIANCE_C_#016	キャラモーション再生(PID_フォガート, Normal, IdleNormal)\n\nキャラカメラ(CharaCam_Front_Center_Top, PID_リュール, cam_anim_pan_u_normal)
MID_RELIANCE_C_#017	キャラモーション再生(PID_リュール, Smile, EmoTalk2,, 0.3)\n\n*\n\nフェードアウト()
MID_RELIANCE_B_#001	キャラ配置(PID_リュール, ME_IN_C, [服装], Normal, IdleNormal, 0)\nキャラ配置(PID_フォガート, YOU_IN_C, [服装], Normal, IdleNormal, 0)\n\nキャラ配置調整(PID_フォガート, 0, 0, 0, -60)\n\n背景(Map_Event_Hub_Solanel_09_Night)\nライト(CharaLight_Hub_Night, 0, 0, 0)\n\nキャラ視線(PID_リュール, PID_フォガート, PID_フォガート)\n\nキャラ表示切替(PID_リュール, False)\n\nキャラモーション再生(PID_フォガート, Sad, EmoTired)\n\nキャラカメラ(CharaCam_SideLong_Right2_Mid, PID_フォガート, cam_anim_zoom_out_normal)\n\nウェイト(0.8)\n\nフェードイン()\n\n*\n\nパペット会話中断()
MID_RELIANCE_B_#002	キャラモーション待ち(PID_フォガート)\n\nキャラ表示切替(PID_リュール, True)\n\nキャラモーション再生(PID_リュール, Smile, WalkIn2)\n\nキャラカメラ(CharaCam_Shoulder_Left_Top, PID_フォガート, cam_anim_track_l_normal)
MID_RELIANCE_B_#003	キャラモーション再生(PID_フォガート, Surprise, TurnR,, 0.3)\n\nキャラ回転(PID_フォガート, 60, 1.5)\n\nキャラ視線(PID_フォガート, PID_リュール, PID_リュール)\n\nキャラカメラ(CharaCam_Shoulder_Right_Mid, PID_リュール, cam_anim_zoom_in_normal)
MID_RELIANCE_B_#004	キャラモーション再生(PID_リュール, Normal, EmoThink)\nキャラモーション再生(PID_フォガート, Surprise, IdleNormal)\n\nキャラカメラ(CharaCam_Side_Left2_Mid, PID_リュール, cam_anim_track_r_slow)
MID_RELIANCE_B_#005	キャラモーション再生(PID_フォガート, Die, EmoDeny2,, 1)\nキャラモーション再生(PID_リュール, Normal, IdleNormal)\n\nキャラカメラ(CharaCam_Side_Right2_Mid, PID_フォガート, cam_anim_track_l_normal)
MID_RELIANCE_B_#006	キャラモーション再生(PID_リュール, Smile)\nキャラモーション再生(PID_フォガート, Die, IdleNormal)\n\nキャラカメラ(CharaCam_Side_Left3_Mid, PID_リュール, cam_anim_pan_d_normal)
MID_RELIANCE_B_#007	キャラモーション再生(PID_フォガート, Sad, EmoThink,, 1)\n\nキャラカメラ(CharaCam_Front_Center_Top, PID_フォガート, cam_anim_pan_u_slow)
MID_RELIANCE_B_#008	キャラモーション再生(PID_フォガート, Shy)
MID_RELIANCE_B_#009	キャラモーション再生(PID_リュール, Surprise)\nキャラモーション再生(PID_フォガート, Shy, IdleNormal)\n\nキャラカメラ(CharaCam_Front_Center_Mid, PID_リュール, cam_anim_zoom_in_normal)
MID_RELIANCE_B_#010	キャラモーション再生(PID_フォガート, Sad)\n\nキャラカメラ(CharaCam_Side_Right2_Top, PID_フォガート, cam_anim_track_l_slow)
MID_RELIANCE_B_#011	キャラモーション再生(PID_フォガート, Die)\n
MID_RELIANCE_B_#012	キャラモーション再生(PID_フォガート, Normal, EmoTalk,, 0.3)\n\nキャラカメラ(CharaCam_Shoulder_Right_Mid, PID_リュール, cam_anim_zoom_in_normal)
MID_RELIANCE_B_#013	キャラモーション再生(PID_リュール, Sad, EmoRelax)\nキャラモーション再生(PID_フォガート, Normal, IdleNormal)\n\nキャラカメラ(CharaCam_Side_Left2_Mid, PID_リュール, cam_anim_track_r_slow)
MID_RELIANCE_B_#014	キャラモーション再生(PID_リュール, Normal)
MID_RELIANCE_B_#015	キャラモーション再生(PID_フォガート, Relax)\nキャラモーション再生(PID_リュール, Normal, IdleNormal)\n\nキャラカメラ(CharaCam_Side_Right2_Mid, PID_フォガート, cam_anim_track_l_normal)
MID_RELIANCE_B_#016	キャラモーション再生(PID_リュール, Smile, EmoTalk)\n\nキャラカメラ(CharaCam_Side_Left3_Mid, PID_リュール, cam_anim_pan_d_normal)\n\n*\n\nフェードアウト()
MID_RELIANCE_A_#001	キャラ配置(PID_リュール, ME_IN_C, [服装], Normal, IdleNormal, 0)\nキャラ配置(PID_フォガート, YOU_IN_C, [服装], Normal, IdleNormal, 0)\n\nキャラ配置調整(PID_フォガート, 0, 0, 0, -150)\n\n背景(Map_Event_Hub_Solanel_09_Night)\nライト(CharaLight_Hub_Night, 0, 0, 0)\n\nキャラ視線(PID_リュール, PID_フォガート, PID_フォガート)\n\nウェイト(1)\n\nキャラモーション再生(PID_フォガート, Angry)\nキャラモーション再生(PID_リュール, Smile, WalkIn2)\n\nキャラカメラ(CharaCam_Shoulder_Left_Top, PID_フォガート, cam_anim_track_l_normal)\n\nフェードイン()
MID_RELIANCE_A_#002	キャラモーション再生(PID_フォガート, Sad, TurnR,, 0.3)\n\nキャラ回転(PID_フォガート, 150, 1.8)\n\nキャラ視線(PID_フォガート, PID_リュール, PID_リュール)\n\nキャラカメラ(CharaCam_Shoulder_Right_Mid, PID_リュール, cam_anim_track2_r_normal)
MID_RELIANCE_A_#003	キャラモーション再生(PID_フォガート, Sad, EmoTalk,, 1)
MID_RELIANCE_A_#004	キャラモーション再生(PID_リュール, Sad)\nキャラモーション再生(PID_フォガート, Sad, IdleNormal)\n\nキャラカメラ(CharaCam_Side_Left3_Mid, PID_リュール, cam_anim_pan_d_normal)
MID_RELIANCE_A_#005	キャラモーション再生(PID_リュール, Sad, EmoRelax,, 0.3)
MID_RELIANCE_A_#006	キャラモーション再生(PID_フォガート, Smile)\nキャラモーション再生(PID_リュール, Sad, IdleNormal)\n\nキャラカメラ(CharaCam_Front_Center_Top, PID_フォガート, cam_anim_pan_u_normal)
MID_RELIANCE_A_#007	キャラモーション再生(PID_リュール, Normal)\n\nキャラカメラ(CharaCam_Side_Left2_Mid, PID_リュール, cam_anim_track_r_normal)
MID_RELIANCE_A_#008	キャラモーション再生(PID_フォガート, Normal)\nキャラモーション再生(PID_フォガート, Die,, 2)\n\nキャラカメラ(CharaCam_Side_Right2_Mid, PID_フォガート, cam_anim_track_l_normal)
MID_RELIANCE_A_#009	キャラモーション再生(PID_リュール, Smile, EmoTalk)\n\nキャラカメラ(CharaCam_Side_Left3_Mid, PID_リュール, cam_anim_pan_d_normal)
MID_RELIANCE_A_#010	キャラモーション再生(PID_フォガート, Smile)\nキャラモーション再生(PID_リュール, Smile, IdleNormal)\n\nキャラカメラ(CharaCam_Front_Center_Top, PID_フォガート, cam_anim_zoom_out_fast)
MID_RELIANCE_A_#011	キャラカメラ(CharaCam_Side_Left2_Mid, PID_リュール, cam_anim_track_r_normal)
MID_RELIANCE_A_#012	キャラモーション再生(PID_フォガート, Sad,, 6)\n\nキャラカメラ(CharaCam_Side_Right2_Mid, PID_フォガート, cam_anim_track_l_slow)
MID_RELIANCE_A_#013	キャラモーション再生(PID_フォガート, Sad)
MID_RELIANCE_A_#014	キャラモーション再生(PID_リュール, Surprise)\nキャラモーション再生(PID_リュール, Sad,, 1)\nキャラモーション再生(PID_フォガート, Die, IdleNormal)\n\nキャラカメラ(CharaCam_Front_Center_Top, PID_リュール, cam_anim_pan_u_normal)
MID_RELIANCE_A_#015	キャラモーション再生(PID_フォガート, Sad, EmoDeny2,, 1)\n\nキャラカメラ(CharaCam_Shoulder_Right_Mid, PID_リュール, cam_anim_zoom_in_slow)
MID_RELIANCE_A_#016	キャラモーション再生(PID_フォガート, Sad, EmoTalk,, 1)\nキャラモーション再生(PID_リュール, Sad, IdleNormal,, 1)
MID_RELIANCE_A_#017	キャラモーション再生(PID_リュール, Smile)\nキャラモーション再生(PID_フォガート, Sad, IdleNormal)\n\nキャラカメラ(CharaCam_Side_Left3_Mid, PID_リュール, cam_anim_pan_d_normal)
MID_RELIANCE_A_#018	キャラモーション再生(PID_フォガート, Shy)\n\nキャラカメラ(CharaCam_Front_Center2_Mid, PID_フォガート, cam_anim_pan_d_slow)
MID_RELIANCE_A_#019	キャラモーション再生(PID_フォガート, Relax, EmoTalk2,, 0.3)\n\n*\n\nフェードアウト()
MID_RELIANCE_S_#001	キャラ配置(PID_リュール, ME_IN_C, [服装], Normal, IdleNormal, 0)\nキャラ配置(PID_フォガート, YOU_IN_C, [服装], Normal, IdleNormal, 0)\n\n背景(Map_Event_M019_02)\nライト(CharaLight_Hub_Day, 0, 0, 0)\n\nキャラ視線(PID_リュール, PID_フォガート, PID_フォガート)\nキャラ視線(PID_フォガート, PID_リュール, PID_リュール)\n\nウェイト(1)\n\nキャラモーション再生(PID_リュール, Smile, EmoTalk)\n\nキャラカメラ(CharaCam_Shoulder_Left_Top, PID_フォガート, cam_anim_track2_l_normal)\n\nフェードイン()
MID_RELIANCE_S_#002	キャラモーション再生(PID_フォガート, Smile, EmoNod,, 0.3)\nキャラモーション再生(PID_リュール, Smile, IdleNormal)\n\nキャラカメラ(CharaCam_Side_Right2_Mid, PID_フォガート, cam_anim_track_l_normal)
MID_RELIANCE_S_#003	キャラモーション再生(PID_フォガート, Smile, IdleNormal)\n\nキャラカメラ(CharaCam_Side_Left2_Mid, PID_リュール, cam_anim_track_r_normal)
MID_RELIANCE_S_#004	キャラモーション再生(PID_フォガート, Shy)\n\nキャラカメラ(CharaCam_Front_Center_Top, PID_フォガート, cam_anim_pan_u_slow)
MID_RELIANCE_S_#005	
MID_RELIANCE_S_#006	キャラモーション再生(PID_リュール, Normal, EmoThink)\n\nキャラカメラ(CharaCam_Side_Left2_Mid, PID_リュール, cam_anim_track_r_normal)
MID_RELIANCE_S_#007	キャラモーション再生(PID_フォガート, Surprise, EmoDeny,, 0.3)\nキャラモーション再生(PID_リュール, Normal, IdleNormal)\n\nキャラカメラ(CharaCam_Side_Right2_Mid, PID_フォガート, cam_anim_track_l_slow)
MID_RELIANCE_S_#008	キャラモーション再生(PID_フォガート, Sad)
MID_RELIANCE_S_#009	キャラモーション再生(PID_フォガート, Angry, IdleNormal,, 1)\n\nキャラカメラ(CharaCam_Shoulder_Right_Mid, PID_リュール, cam_anim_zoom_in_normal)
MID_RELIANCE_S_#010	キャラモーション再生(PID_リュール, Surprise)\nキャラモーション再生(PID_フォガート, Angry, IdleNormal)\n\nキャラカメラ(CharaCam_Front_Center_Top, PID_リュール, cam_anim_pan_u_normal)
MID_RELIANCE_S_#011	キャラモーション再生(PID_フォガート, Angry)\n\nキャラカメラ(CharaCam_Side_Right3_Mid, PID_フォガート, cam_anim_pan_d_normal)
MID_RELIANCE_S_#012	キャラモーション再生(PID_リュール, Surprise, EmoDeny2)\n\nキャラカメラ(CharaCam_Side_Left2_Mid, PID_リュール, cam_anim_track_r_normal)
MID_RELIANCE_S_#013	キャラモーション再生(PID_フォガート, Sad, EmoSad2,, 1)\n\nキャラカメラ(CharaCam_Side_Right2_Mid, PID_フォガート, cam_anim_track_l_normal)
MID_RELIANCE_S_#014	キャラモーション再生(PID_リュール, Shy)\nキャラモーション再生(PID_フォガート, Sad, IdleNormal)\n\nキャラカメラ(CharaCam_Side_Left3_Mid, PID_リュール, cam_anim_pan_d_slow)
MID_RELIANCE_S_#015	
MID_RELIANCE_S_#016	キャラモーション再生(PID_フォガート, Surprise, EmoShy,, 0.3)\n\nキャラカメラ(CharaCam_Front_Center2_Mid, PID_フォガート, cam_anim_pan_d_normal)
MID_RELIANCE_S_#017	キャラモーション再生(PID_リュール, Smile)\nキャラモーション再生(PID_フォガート, Surprise, IdleNormal)\n\nキャラカメラ(CharaCam_Front_Center_Top, PID_リュール, cam_anim_pan_u_slow)
MID_RELIANCE_S_#018	キャラモーション再生(PID_リュール, Smile, EmoNod,, 0.3)
MID_RELIANCE_S_#019	キャラモーション再生(PID_リュール, Smile, EmoGive,, 1)\n\n一枚絵表示(Tex_Event_ItemPicture_14, picture_item_fade_in_normal)\n\nキャラカメラ(CharaCam_Shoulder_Left_Top, PID_フォガート, cam_anim_track2_l_normal)\n\n*\n\nパペット会話中断()\n\nウェイト(1)\n\n一枚絵非表示(picture_item_fade_out_normal)\n\nウェイト(1)
MID_RELIANCE_S_#020	キャラモーション再生(PID_フォガート, Surprise)\nキャラモーション再生(PID_リュール, Smile, IdleNormal)\n\nキャラカメラ(CharaCam_Side_Right3_Mid, PID_フォガート, cam_anim_pan_d_normal)
MID_RELIANCE_S_#021	キャラカメラ(CharaCam_Front_Center_Mid, PID_リュール, cam_anim_zoom_out_slow)
MID_RELIANCE_S_#022	キャラモーション再生(PID_リュール, Smile, EmoRelax,, 0.3)
MID_RELIANCE_S_#023	キャラモーション再生(PID_フォガート, Shy, EmoSad,, 0.3)\nキャラモーション再生(PID_リュール, Smile, IdleNormal)\n\nキャラカメラ(CharaCam_Front_Center_Top, PID_フォガート, cam_anim_pan_u_normal)
MID_RELIANCE_S_#024	キャラモーション再生(PID_リュール, Smile, EmoRelax)\nキャラモーション再生(PID_フォガート, Smile, IdleNormal)\n\nキャラカメラ(CharaCam_Side_Left2_Mid, PID_リュール, cam_anim_track_r_normal)
MID_RELIANCE_S_#025	キャラモーション再生(PID_フォガート, Relax)\nキャラモーション再生(PID_リュール, Smile, IdleNormal)\n\nキャラカメラ(CharaCam_Side_Right2_Mid, PID_フォガート, cam_anim_track_l_normal)\n\n*\n\nパペット会話中断()
MID_RELIANCE_S_#026	フェードアウト()\n一枚絵表示(Tex_Event_Reliance_S_25)\nウェイト(0.8)\n\nフェードイン()\nウェイト(1.2)\n\n*\n\nウェイト(1)\nフェードアウト()
