MID_RELIANCE_C_#001	キャラ配置(PID_リュール, ME_IN_C)\nキャラ配置(PID_ルイ, YOU_IN_C,, Normal, IdleNormal, -80)\n\n背景(Map_Event_Hub_Solanel_03_Day)\nライト(CharaLight_Hub_Day)\n\nキャラ視線(PID_リュール, PID_ルイ, PID_ルイ)\n\nシーンカメラ(SceneCam_SideYou_Right_Mid, cam_anim_pan_r_normal)\nキャラモーション再生(PID_リュール, , WalkIn2)\nフェードイン()\n*\nキャラモーション再生(PID_リュール, Surprise, IdleNormal,,1)
MID_RELIANCE_C_#002	キャラカメラ(CharaCam_FrontLong2_Right_Mid, PID_ルイ, cam_anim_track_l_normal)\nキャラモーション再生(PID_ルイ, , EmoTalk,,1)\nキャラ視線(PID_ルイ, PID_リュール, PID_リュール)
MID_RELIANCE_C_#003	キャラモーション再生(PID_ルイ, , EmoThink,,1)\n*\nキャラモーション再生(PID_ルイ, Angry, IdleNormal)
MID_RELIANCE_C_#004	キャラカメラ(CharaCam_Side_Left2_Mid, PID_リュール, cam_anim_track_r_normal)\n*\nキャラモーション再生(PID_リュール, Normal)
MID_RELIANCE_C_#005	キャラカメラ(CharaCam_SideLong_Right2_Mid, PID_ルイ, cam_anim_pan_u_slow)\nキャラモーション再生(PID_ルイ, , TurnR,, 0.3)\nキャラモーション再生(PID_ルイ, , EmoThinkIn, 1, 1)\nキャラ回転(PID_ルイ, 80, 1)
MID_RELIANCE_C_#006	
MID_RELIANCE_C_#007	キャラカメラ(CharaCam_FrontLong2_Right_Mid, PID_ルイ, cam_anim_track_l_normal)\nキャラモーション再生(PID_ルイ, Relax, EmoTalk,,1)\n*\nキャラモーション再生(PID_ルイ, Smile, IdleNormal)
MID_RELIANCE_C_#008	 キャラカメラ(CharaCam_Side_Left3_Mid, PID_リュール, cam_anim_track_l_normal)\n*\nキャラモーション再生(PID_リュール, Sad, IdleNormal,,1)
MID_RELIANCE_C_#009	キャラカメラ(CharaCam_Side_Right2_Mid, PID_ルイ, cam_anim_track_l_normal)\nキャラモーション再生(PID_ルイ, , EmoNod,,1)\n*\nキャラモーション再生(PID_ルイ, Normal, IdleNormal,,1)
MID_RELIANCE_C_#010	キャラモーション再生(PID_ルイ, , EmoDeny2, 3, 1)
MID_RELIANCE_C_#011	キャラカメラ(CharaCam_FrontLong2_Right_Mid, PID_ルイ, cam_anim_track_l_normal)\nキャラモーション再生(PID_ルイ, , EmoProud,,1)\n*\nキャラモーション再生(PID_ルイ, Normal, IdleNormal,,1)
MID_RELIANCE_C_#012	キャラカメラ(CharaCam_FrontLong2_Left_Top, PID_リュール, cam_anim_pan_l_normal)\nキャラモーション再生(PID_リュール, , EmoSad,,1)
MID_RELIANCE_C_#013	キャラモーション再生(PID_リュール, Normal, EmoTalk,,1)
MID_RELIANCE_C_#014	キャラカメラ(CharaCam_Side_Left3_Mid, PID_リュール, cam_anim_track_l_normal)\n*\nキャラモーション再生(PID_リュール, Relax, IdleNormal,,1)
MID_RELIANCE_C_#015	キャラカメラ(CharaCam_FrontLong2_Right_Mid, PID_ルイ, cam_anim_track_l_normal)\nキャラモーション再生(PID_ルイ, , EmoTalk2,,1)
MID_RELIANCE_C_#016	*\nキャラモーション再生(PID_ルイ, Normal, IdleNormal,,1)
MID_RELIANCE_C_#017	キャラカメラ(CharaCam_FrontLong2_Left_Top, PID_リュール, cam_anim_pan_l_normal)\nキャラモーション再生(PID_リュール, , EmoTalk,,1)\n*\nキャラモーション再生(PID_リュール, Normal, IdleNormal,,1)
MID_RELIANCE_C_#018	キャラカメラ(CharaCam_FrontLong2_Right_Mid, PID_ルイ, cam_anim_track_l_normal)\nキャラモーション再生(PID_ルイ, , EmoNod,,1)\n*\nフェードアウト()
MID_RELIANCE_B_#001	キャラ配置(PID_リュール, ME_IN_C)\nキャラ配置(PID_ルイ, YOU_IN_C,, Normal, IdleNormal, -90)\nキャラ表示切替(PID_リュール, False)\n\n背景(Map_Event_Hub_Solanel_04_Day)\nライト(CharaLight_Hub_Day)\n\nキャラ視線(PID_リュール, PID_ルイ, PID_ルイ)\n\nシーンカメラ(SceneCam_SideYou_Right_Mid, cam_anim_track_l_normal)\n\nフェードイン()\n*\nキャラ表示切替(PID_リュール, True)
MID_RELIANCE_B_#002	キャラカメラ(CharaCam_FrontLong2_Left_Top, PID_リュール, cam_anim_pan_l_normal)\nキャラモーション再生(PID_リュール, , WalkIn2)\nキャラ視線(PID_ルイ, PID_リュール, PID_リュール, 1)\n*\nキャラモーション再生(PID_リュール, Normal, IdleNormal)\nキャラ視線(PID_ルイ, PID_リュール, PID_リュール)
MID_RELIANCE_B_#003	キャラカメラ(CharaCam_Side_Right2_Mid, PID_ルイ, cam_anim_track_l_normal)\nキャラモーション再生(PID_ルイ, , TurnR,, 0.3)\nキャラ回転(PID_ルイ, 90, 1)
MID_RELIANCE_B_#004	キャラカメラ(CharaCam_FrontLong2_Left_Top, PID_リュール, cam_anim_pan_l_normal)\nキャラモーション再生(PID_リュール, , EmoTalk,,1)\n*\nキャラモーション再生(PID_リュール, Normal, IdleNormal,,1)
MID_RELIANCE_B_#005	キャラカメラ(CharaCam_FrontLong2_Right_Mid, PID_ルイ, cam_anim_track_l_normal)\nキャラモーション再生(PID_ルイ, , EmoNod,,1)
MID_RELIANCE_B_#006	キャラモーション再生(PID_ルイ, , EmoPray,,1)\n*\nキャラモーション再生(PID_ルイ, Normal, IdleNormal,,1)
MID_RELIANCE_B_#007	キャラカメラ(CharaCam_FrontLong2_Left_Top, PID_リュール, cam_anim_pan_r_normal)\nキャラモーション再生(PID_リュール, , EmoThink,,1)\n*\nキャラモーション再生(PID_リュール, Relax, IdleNormal)
MID_RELIANCE_B_#008	キャラカメラ(CharaCam_Side_Right3_Mid, PID_ルイ, cam_anim_track_r_normal)\nキャラモーション再生(PID_ルイ, , EmoNod,,1)\n*\nキャラモーション再生(PID_ルイ, Normal, IdleNormal)
MID_RELIANCE_B_#009	キャラカメラ(CharaCam_Side_Left2_Mid, PID_リュール, cam_anim_track_r_normal)\n*\nキャラモーション再生(PID_リュール, Smile)
MID_RELIANCE_B_#010	キャラカメラ(CharaCam_SideLong_Right2_Mid, PID_ルイ, cam_anim_pan_u_slow)\nキャラモーション再生(PID_ルイ, , EmoThink,,1)
MID_RELIANCE_B_#011	
MID_RELIANCE_B_#012	キャラカメラ(CharaCam_FrontLong2_Right_Mid, PID_ルイ, cam_anim_track_l_normal)\nキャラモーション再生(PID_ルイ, Relax, EmoPray,,1)\n*\nキャラモーション再生(PID_ルイ, Normal, IdleNormal,,1)
MID_RELIANCE_B_#013	キャラカメラ(CharaCam_FrontLong2_Left_Top, PID_リュール, cam_anim_pan_l_normal)\nキャラモーション再生(PID_リュール, , EmoTalk,,1)\n*\nキャラモーション再生(PID_リュール, Surprise, IdleNormal,,1)
MID_RELIANCE_B_#014	キャラカメラ(CharaCam_FrontLong2_Right_Mid, PID_ルイ, cam_anim_track_l_normal)\nキャラモーション再生(PID_ルイ, , EmoNod,,1)
MID_RELIANCE_B_#015	キャラモーション再生(PID_ルイ, , EmoThink,,1)\n*\nキャラモーション再生(PID_ルイ, Normal, IdleNormal)
MID_RELIANCE_B_#016	キャラカメラ(CharaCam_Side_Left2_Mid, PID_リュール, cam_anim_pan_l_normal)\n*\nキャラモーション再生(PID_リュール, Surprise)
MID_RELIANCE_B_#017	キャラカメラ(CharaCam_SideLong_Right2_Mid, PID_ルイ, cam_anim_pan_u_slow)\nキャラモーション再生(PID_ルイ, , EmoPray,,1)\n*\nキャラモーション再生(PID_ルイ, Normal, IdleNormal,,1)
MID_RELIANCE_B_#018	キャラカメラ(CharaCam_FrontLong2_Left_Top, PID_リュール, cam_anim_pan_l_normal)\nキャラモーション再生(PID_リュール, , EmoNod,,1)
MID_RELIANCE_B_#019	キャラモーション再生(PID_リュール, , EmoTalk,,1)\n*\nキャラモーション再生(PID_リュール, Sad, IdleNormal,,1)
MID_RELIANCE_B_#020	キャラカメラ(CharaCam_FrontLong2_Right_Mid, PID_ルイ, cam_anim_track_l_normal)\nキャラモーション再生(PID_ルイ, , EmoDeny,,1)\n*\nキャラモーション再生(PID_ルイ, Smile, IdleNormal)
MID_RELIANCE_B_#021	キャラカメラ(CharaCam_Side_Left2_Mid, PID_リュール, cam_anim_track_r_normal)\nキャラモーション再生(PID_リュール, , EmoShy,,1)\n*\nキャラモーション再生(PID_リュール, Normal, IdleNormal)
MID_RELIANCE_B_#022	キャラカメラ(CharaCam_Side_Right3_Mid, PID_ルイ, cam_anim_zoom_in_normal)\nキャラモーション再生(PID_ルイ, , EmoNod,,1)\n*\nフェードアウト()
MID_RELIANCE_A_#001	キャラ配置(PID_リュール, ME_IN_C,, Normal, IdleNormal)\nキャラ配置(PID_ルイ, YOU_IN_C,, Normal, IdleNormal)\n\n背景(Map_Event_Hub_Solanel_19_Day)\nライト(CharaLight_Hub_Day)\n\nキャラ視線(PID_リュール, PID_ルイ, PID_ルイ)\nキャラ視線(PID_ルイ, PID_リュール, PID_リュール)\n\nウェイト(0.4)\n\nシーンカメラ(SceneCam_SideMe_Right_Mid, cam_anim_zoom_in_normal)\nフェードイン()\n\nキャラモーション再生(PID_ルイ, , EmoNod,,1)
MID_RELIANCE_A_#002	キャラモーション再生(PID_ルイ, , EmoDeny2,,1)\n*\nキャラモーション再生(PID_ルイ, Sad, IdleNormal,,1)
MID_RELIANCE_A_#003	キャラカメラ(CharaCam_FrontLong2_Left_Top, PID_リュール, cam_anim_pan_l_normal)\nキャラモーション再生(PID_リュール, , EmoDeny,,1)\nキャラモーション再生(PID_リュール, Smile,,3)
MID_RELIANCE_A_#004	キャラモーション再生(PID_リュール, Normal, EmoTalk,,1)\n*\nキャラモーション再生(PID_リュール, Normal, IdleNormal)
MID_RELIANCE_A_#005	キャラカメラ(CharaCam_Side_Right2_Top, PID_ルイ, cam_anim_track_l_normal)\nキャラモーション再生(PID_ルイ, , EmoThink,,1)\n*\nキャラモーション再生(PID_ルイ, Normal, IdleNormal)
MID_RELIANCE_A_#006	キャラカメラ(CharaCam_Side_Left2_Mid, PID_リュール, cam_anim_track_r_normal)\n*\nキャラモーション再生(PID_リュール, Smile)
MID_RELIANCE_A_#007	キャラカメラ(CharaCam_FrontLong2_Right_Mid, PID_ルイ, cam_anim_track_l_normal)\nキャラモーション再生(PID_ルイ, , EmoPray,,1)
MID_RELIANCE_A_#008	キャラモーション再生(PID_ルイ, Sad, EmoDeny2,,1)\n*\nキャラモーション再生(PID_ルイ, Surprise, IdleNormal,,1)
MID_RELIANCE_A_#009	キャラカメラ(CharaCam_FrontLong2_Left_Top, PID_リュール, cam_anim_pan_l_normal)\nキャラモーション再生(PID_リュール, , EmoTalk,,1)\n*\nキャラモーション再生(PID_リュール, Smile, IdleNormal)
MID_RELIANCE_A_#010	キャラカメラ(CharaCam_Side_Right3_Mid, PID_ルイ, cam_anim_track_r_normal)
MID_RELIANCE_A_#011	キャラモーション再生(PID_ルイ, Normal, EmoThink,, 0.3)\n*\nキャラ表示切替(PID_ルイ, False)\nキャラモーション再生(PID_ルイ, Normal, IdleNormal)
MID_RELIANCE_A_#012	キャラカメラ(CharaCam_SideLong_Left2_Mid, PID_リュール, cam_anim_pan_u_slow)\nキャラモーション再生(PID_リュール, , EmoPray, 2, 1)
MID_RELIANCE_A_#013	キャラモーション再生(PID_リュール, Normal, EmoTalk,,1)\n*\nキャラモーション再生(PID_リュール, Normal, IdleNormal,,1)\nキャラ表示切替(PID_ルイ, True)
MID_RELIANCE_A_#014	キャラカメラ(CharaCam_FrontLong2_Right_Mid, PID_ルイ, cam_anim_pan_r_slow)
MID_RELIANCE_A_#015	キャラモーション再生(PID_ルイ, Relax, EmoNod,,1)\nキャラモーション再生(PID_ルイ, , EmoPray, 3, 1)
MID_RELIANCE_A_#016	キャラモーション再生(PID_ルイ, , EmoTalk,,1)\n*\nキャラモーション再生(PID_ルイ, Relax, IdleNormal)
MID_RELIANCE_A_#017	キャラカメラ(CharaCam_Side_Left2_Mid, PID_リュール, cam_anim_track_r_normal)\n*\nキャラモーション再生(PID_リュール, Smile)
MID_RELIANCE_A_#018	キャラカメラ(CharaCam_SideLong_Right2_Mid, PID_ルイ, cam_anim_pan_u_slow)\nキャラモーション再生(PID_ルイ, , EmoTalk2,,1)
MID_RELIANCE_A_#019	キャラモーション再生(PID_ルイ, , EmoNod,,1)\n*\nキャラモーション再生(PID_ルイ, Normal, IdleNormal)
MID_RELIANCE_A_#020	キャラカメラ(CharaCam_Side_Left3_Mid, PID_リュール, cam_anim_zoom_in_slow)\nキャラモーション再生(PID_リュール, , EmoShy,,1)\n*\nフェードアウト()
MID_RELIANCE_S_#001	キャラ配置(PID_リュール, YOU_IN_C,, Normal, IdleNormal)\nキャラ配置(PID_ルイ, ME_IN_C,, Normal, IdleNormal)\n\n背景(Map_Event_Hub_Solanel_01_Evening)\nライト(CharaLight_Hub_Evening)\n\nキャラ視線(PID_リュール, PID_ルイ, PID_ルイ)\nキャラ視線(PID_ルイ, PID_リュール, PID_リュール)\n\nウェイト(0.4)\n\nキャラカメラ(CharaCam_FrontLong2_Left_Top, PID_リュール, cam_anim_pan_l_normal)\nキャラモーション再生(PID_リュール, Normal, WalkIn2)\nフェードイン()\n*\nキャラモーション再生(PID_リュール, Surprise, IdleNormal,,1)
MID_RELIANCE_S_#002	キャラカメラ(CharaCam_FrontLong2_Right_Mid, PID_ルイ, cam_anim_track_l_normal)\nキャラモーション再生(PID_ルイ, , EmoNod,,1)
MID_RELIANCE_S_#003	キャラモーション再生(PID_ルイ, Sad, IdleNormal,,1)\nキャラカメラ(CharaCam_Side_Right2_Mid, PID_ルイ, cam_anim_zoom_in_slow)\n*\nキャラモーション再生(PID_ルイ, Normal, IdleNormal,,1)
MID_RELIANCE_S_#004	キャラカメラ(CharaCam_FrontLong2_Left_Top, PID_リュール, cam_anim_pan_l_normal)\n*\nキャラモーション再生(PID_リュール, Normal)
MID_RELIANCE_S_#005	キャラカメラ(CharaCam_Side_Right3_Mid, PID_ルイ, cam_anim_track_r_normal)\nキャラモーション再生(PID_ルイ, , EmoShy,,1)\n*\nキャラモーション再生(PID_ルイ, Sad, IdleNormal)
MID_RELIANCE_S_#006	キャラカメラ(CharaCam_Side_Left2_Mid, PID_リュール, cam_anim_track_r_normal)\nキャラモーション再生(PID_リュール, , EmoDeny,,1)\n*\nキャラモーション再生(PID_リュール, Normal, IdleNormal)
MID_RELIANCE_S_#007	キャラカメラ(CharaCam_Side_Right3_Mid, PID_ルイ, cam_anim_zoom_in_slow)
MID_RELIANCE_S_#008	キャラカメラ(CharaCam_FrontLong2_Left_Top, PID_リュール, cam_anim_pan_r_normal)\nキャラモーション再生(PID_リュール, , EmoTalk,,1)\n*\nキャラモーション再生(PID_リュール, Normal, IdleNormal)
MID_RELIANCE_S_#009	キャラカメラ(CharaCam_SideLong_Right2_Mid, PID_ルイ, cam_anim_pan_u_slow)\nキャラモーション再生(PID_ルイ, , EmoDeny2,,1)
MID_RELIANCE_S_#010	キャラモーション再生(PID_ルイ, , EmoPray,,1)
MID_RELIANCE_S_#011	キャラカメラ(CharaCam_FrontLong2_Right_Mid, PID_ルイ, cam_anim_track_l_normal)\nキャラモーション再生(PID_ルイ, , EmoSad2,,1)\n*\nキャラモーション再生(PID_ルイ, Normal, IdleNormal)
MID_RELIANCE_S_#012	キャラカメラ(CharaCam_Side_Left2_Mid, PID_リュール, cam_anim_track_r_normal)\nキャラモーション再生(PID_リュール, , EmoRelax,,1)\n*\nキャラモーション再生(PID_リュール, Smile, IdleNormal,,1)
MID_RELIANCE_S_#013	キャラカメラ(CharaCam_FrontLong2_Right_Mid, PID_ルイ, cam_anim_pan_l_normal)\nキャラモーション再生(PID_ルイ, , EmoTalk,,1)\n*\nキャラモーション再生(PID_ルイ, Sad, IdleNormal)
MID_RELIANCE_S_#014	キャラカメラ(CharaCam_Side_Left2_Mid, PID_リュール, cam_anim_track_r_normal)\nキャラモーション再生(PID_リュール, , EmoNod,,1)\nキャラモーション再生(PID_リュール, , IdleNormal, 1.5, 1)\n*\nキャラモーション再生(PID_リュール, Surprise, IdleNormal)
MID_RELIANCE_S_#015	キャラカメラ(CharaCam_Side_Right3_Mid, PID_ルイ, cam_anim_zoom_in_normal)\nキャラモーション再生(PID_ルイ, , EmoSad2,,1)
MID_RELIANCE_S_#016	キャラカメラ(CharaCam_SideLong_Right2_Mid, PID_ルイ, cam_anim_pan_u_slow)\nキャラモーション再生(PID_ルイ, Shy, EmoPray, 4, 1)\n*\nキャラモーション再生(PID_ルイ, Normal, IdleNormal)
MID_RELIANCE_S_#017	キャラカメラ(CharaCam_Side_Left3_Top, PID_リュール, cam_anim_zoom_in_slow)\n*\nキャラモーション再生(PID_リュール, Normal)
MID_RELIANCE_S_#018	キャラカメラ(CharaCam_SideLong_Right2_Mid, PID_ルイ, cam_anim_pan_u_slow)\nキャラモーション再生(PID_ルイ, , EmoTalk,,1)
MID_RELIANCE_S_#019	キャラモーション再生(PID_ルイ, , EmoPray,,1)
MID_RELIANCE_S_#020	キャラカメラ(CharaCam_FrontLong2_Right_Mid, PID_ルイ, cam_anim_pan_l_slow)\nキャラモーション再生(PID_ルイ, , EmoShy,,1)\nキャラモーション再生(PID_ルイ, , EmoGive, 3.5,1)\n*\nキャラモーション再生(PID_ルイ, Sad, IdleNormal)
MID_RELIANCE_S_#021	キャラカメラ(CharaCam_Side_Left2_Top, PID_リュール, cam_anim_zoom_in_slow)\nキャラモーション再生(PID_リュール, , EmoThinkIn,,1)
MID_RELIANCE_S_#022	*\nキャラモーション再生(PID_リュール, Smile, IdleNormal)
MID_RELIANCE_S_#023	キャラカメラ(CharaCam_Side_Right3_Mid, PID_ルイ, cam_anim_track_r_normal)\nキャラモーション再生(PID_ルイ, , EmoSad2,,1)\n*\nキャラモーション再生(PID_ルイ, Surprise, IdleNormal)
MID_RELIANCE_S_#024	キャラカメラ(CharaCam_Side_Left_Mid, PID_リュール, cam_anim_dolly_l_normal)
MID_RELIANCE_S_#025	キャラカメラ(CharaCam_FrontLong2_Right_Mid, PID_ルイ, cam_anim_track_l_normal)
MID_RELIANCE_S_#026	キャラモーション再生(PID_ルイ, Normal, EmoNod,,1)\nキャラモーション再生(PID_ルイ, , IdleNormal, 1.5, 1)\n*\nキャラモーション再生(PID_ルイ, Surprise, IdleNormal,,1)
MID_RELIANCE_S_#027	キャラカメラ(CharaCam_FrontLong2_Left_Top, PID_リュール, cam_anim_pan_l_normal)\nキャラモーション再生(PID_リュール, , EmoRelax,,1)
MID_RELIANCE_S_#028	キャラモーション再生(PID_リュール, , EmoPray,,1)
MID_RELIANCE_S_#029	ライト(CharaLight_Hub_Evening, 0, -20, 0)\nキャラカメラ(CharaCam_SideLong_Left_Mid, PID_リュール, cam_anim_track_l_normal)\nキャラモーション再生(PID_リュール, , EmoGive,,1)\n一枚絵表示(Tex_Event_ItemPicture_14, picture_item_fade_in_normal)\n*\nキャラモーション再生(PID_リュール, Smile, IdleNormal)
MID_RELIANCE_S_#030	ライト(CharaLight_Hub_Evening, 0, 0, 0)\nキャラカメラ(CharaCam_SideLong_Right_Mid, PID_ルイ, cam_anim_track_r_normal)\nキャラモーション再生(PID_ルイ, Smile, IdleNormal, 2, 1)\n*\n一枚絵非表示(picture_item_fade_out_normal)
MID_RELIANCE_S_#031	キャラモーション再生(PID_ルイ, , EmoTalk,,1)\n*\nキャラモーション再生(PID_ルイ, Normal, IdleNormal,,1)
MID_RELIANCE_S_#032	キャラカメラ(CharaCam_Side_Left3_Top, PID_リュール, cam_anim_zoom_in_slow)\n\n*\n\nパペット会話中断()
MID_RELIANCE_S_#033	フェードアウト()\n一枚絵表示(Tex_Event_Reliance_S_08)\nウェイト(0.8)\n\nフェードイン()\nウェイト(1.2)\n\n*\n\nウェイト(1)\nフェードアウト()
