MID_RELIANCE_C_#001	キャラ配置(PID_エル, ME_IN_C,, Normal, IdleNormal)\nキャラ配置(PID_リュール, YOU_IN_C,, Normal, IdleNormal)\n\n背景(Map_Event_Hub_Solanel_03_Day)\nライト(CharaLight_Hub_Day)\n\nキャラ視線(PID_リュール, PID_エル, PID_エル)\nキャラ視線(PID_エル, PID_リュール, PID_リュール)\n\nキャラモーション再生(PID_リュール, Normal, EmoTalk2,,1)\n\nキャラカメラ(CharaCam_Shoulder_Right_Top, PID_エル, cam_anim_track_r_normal)\n\n\nフェードイン()
MID_RELIANCE_C_#002	キャラカメラ(CharaCam_Side_Left3_Mid, PID_エル, cam_anim_track_r_normal)\n\nキャラモーション再生(PID_エル, Normal, EmoRelax, 0.8,1)\nキャラモーション再生(PID_リュール, Normal, IdleNormal)
MID_RELIANCE_C_#003	キャラカメラ(CharaCam_SideLong_Right2_Mid, PID_リュール, cam_anim_pan_r_normal)\n\nキャラモーション再生(PID_リュール, Smile,,,1)\nキャラモーション再生(PID_リュール, Smile, EmoTalk, 1.5,1)\nキャラモーション再生(PID_エル, Normal, IdleNormal)
MID_RELIANCE_C_#004	キャラカメラ(CharaCam_FrontLong2_Left_Mid, PID_エル, cam_anim_pan_d_normal)\n\nキャラモーション再生(PID_エル, Normal, EmoTalk, 2.8,1)\nキャラモーション再生(PID_リュール, Normal, IdleNormal,,1)
MID_RELIANCE_C_#005	キャラカメラ(CharaCam_SideLong_Left2_Mid, PID_エル, cam_anim_track3_r_normal)\n\nキャラモーション再生(PID_エル, Normal, EmoThink,,1)
MID_RELIANCE_C_#006	キャラモーション再生(PID_エル, Normal, EmoJoy,,1)
MID_RELIANCE_C_#007	キャラカメラ(CharaCam_Front_Center2_Mid, PID_リュール, cam_anim_zoom_in_normal)\n\nキャラモーション再生(PID_リュール, Smile,,,1)\nキャラモーション再生(PID_エル, Normal, IdleNormal)
MID_RELIANCE_C_#008	キャラカメラ(CharaCam_Side_Left4_Mid, PID_エル, cam_anim_pan_l_normal)\n\nキャラモーション再生(PID_リュール, Normal, IdleNormal)
MID_RELIANCE_C_#009	キャラカメラ(CharaCam_Side_Right3_Mid, PID_リュール, cam_anim_track_l_normal)\n\nキャラモーション再生(PID_リュール, Smile, EmoTalk2, 2.8,1)\nキャラモーション再生(PID_エル, Normal, IdleNormal)
MID_RELIANCE_C_#010	キャラカメラ(CharaCam_Side_Left2_Mid, PID_エル, cam_anim_pan_l_normal)\n\nキャラモーション再生(PID_エル, Surprise,,, 1)\nキャラモーション再生(PID_リュール, Normal, IdleNormal)
MID_RELIANCE_C_#011	キャラモーション再生(PID_エル, Die, EmoRelax,,1)\nキャラモーション再生(PID_エル, Normal,, 4,1)
MID_RELIANCE_C_#012	キャラカメラ(CharaCam_Shoulder_Right_Mid, PID_エル, cam_anim_track3_r_normal)\n\nキャラモーション再生(PID_エル, Normal, EmoDeny2,,1)\nキャラモーション再生(PID_エル, Normal, EmoTalk, 4,1)\n\n*\nパペット会話中断()\nキャラ視線リセット(PID_エル)\n\nキャラモーション再生(PID_エル, Die, TurnL,,1)\nキャラ回転(PID_エル, -160,1)\nキャラモーション再生(PID_エル, Shy, WalkOut, 1,1)\nウェイト(2.2)
MID_RELIANCE_C_#013	キャラモーション再生(PID_リュール, Shy, EmoShy,,1)\n
MID_RELIANCE_C_#014	キャラモーション再生(PID_リュール, Smile,,,1)\n
MID_RELIANCE_C_#015	キャラカメラ(CharaCam_Side_Right2_Mid, PID_リュール, cam_anim_zoom_in_normal)\n\nキャラモーション再生(PID_リュール, Die,,,1)\nキャラモーション再生(PID_リュール, Smile,, 1.5,1)\n\n*\nフェードアウト()
MID_RELIANCE_B_#001	キャラ配置(PID_エル, ME_IN_C,, Normal, IdleNormal, -60)\nキャラ配置(PID_リュール, YOU_IN_C,, Normal, IdleNormal, -110)\nキャラ配置(PID_エル, -0.2,\nキャラ配置(PID_リュール, -0.2)\n\nキャラ配置(PID_デモ用_視線設定用, YOU_IN_D)\nキャラ配置調整(PID_デモ用_視線設定用, -1, -0.6, 0)\nキャラ表示切替(PID_デモ用_視線設定用, False)\n\n背景(Map_Event_Hub_Solanel_01_Evening)\nライト(CharaLight_Hub_Day)\n\nキャラ視線(PID_リュール, PID_エル, PID_エル, 2.5)\nキャラ視線(PID_エル, PID_リュール, PID_リュール)\n\nキャラモーション再生(PID_リュール, Normal, WalkIn)\nウェイト(1)\n\nキャラ回転(PID_エル, 60, 3, 3)\nキャラモーション再生(PID_エル, Normal, EmoTalk2,,1)\nキャラモーション再生(PID_リュール, Normal, TurnR,3,1)\nキャラ回転(PID_リュール, 90, 1, 3)\n\nシーンカメラ(SceneCam_SideYou_Right_Mid, cam_anim_track_r_normal)\n\nフェードイン()\n\n*\nパペット会話中断()
MID_RELIANCE_B_#002	キャラモーション待ち(PID_リュール)\n\nキャラカメラ(CharaCam_FrontLong2_Right_Mid, PID_リュール, cam_anim_zoom_in_normal)\n\nキャラモーション再生(PID_リュール, Normal, EmoTalk2,,1)\nキャラモーション再生(PID_リュール, Sad, , 4.8,1)\nキャラモーション再生(PID_エル, Normal, IdleNormal,,1)
MID_RELIANCE_B_#003	キャラカメラ(CharaCam_Side_Left3_Mid, PID_エル, cam_anim_track_r_normal)\n\nキャラモーション再生(PID_エル, Normal, EmoNod,,1)\nキャラモーション再生(PID_リュール, Normal, IdleNormal)\nキャラ回転(PID_リュール, 20)
MID_RELIANCE_B_#004	キャラモーション再生(PID_エル, Die,,,1)\nキャラモーション再生(PID_エル, Normal, EmoRelax, 3,1)
MID_RELIANCE_B_#005	キャラモーション再生(PID_エル, Amgry, EmoTalk2,,0.5)
MID_RELIANCE_B_#006	キャラカメラ(CharaCam_Side_Right2_Mid, PID_リュール, cam_anim_track_l_normal)\n\nキャラモーション再生(PID_リュール, Shy,,,1)\nキャラモーション再生(PID_リュール,, EmoDeny, 1.5,1)\nキャラモーション再生(PID_エル, Normal, IdleNormal)
MID_RELIANCE_B_#007	シーンカメラ(SceneCam_SideYou_Right_Mid, cam_anim_track3_r_normal)\n\nキャラモーション再生(PID_エル, Normal, EmoDeny2,,1)\nキャラモーション再生(PID_リュール, Normal, IdleNormal,,1)
MID_RELIANCE_B_#008	キャラモーション再生(PID_リュール, Smile, EmoRelax,,0.5)
MID_RELIANCE_B_#009	キャラモーション再生(PID_エル, Die,,,1)\nキャラモーション再生(PID_エル, Sad, EmoRelax, 3.8,1)
MID_RELIANCE_B_#010	キャラカメラ(CharaCam_SideLong_Left2_Mid, PID_エル, cam_anim_zoom_in_normal)\n\nキャラモーション再生(PID_エル, Normal, EmoNod,,1)\nキャラモーション再生(PID_リュール, Normal, IdleNormal)
MID_RELIANCE_B_#011	キャラモーション再生(PID_エル, Angry,,,1)\nキャラモーション再生(PID_エル, Angry, EmoPray, 2.8,1)
MID_RELIANCE_B_#012	キャラカメラ(CharaCam_Side_Right_Mid, PID_リュール, cam_anim_pan_r_normal)\n\nキャラモーション再生(PID_リュール, Sad, EmoNod,,0.5)\nキャラモーション再生(PID_エル, Normal, IdleNormal)
MID_RELIANCE_B_#013	キャラカメラ(CharaCam_Side_Left2_Mid, PID_エル, cam_anim_pan_l_normal)\n\nキャラモーション再生(PID_エル, Die, EmoDeny2,,1)\nキャラモーション再生(PID_エル, Normal,, 4,1)\nキャラモーション再生(PID_リュール, Normal, IdleNormal)
MID_RELIANCE_B_#014	キャラカメラ(CharaCam_FrontLong2_Right_Mid, PID_リュール, cam_anim_track_r_normal)\n\nキャラモーション再生(PID_リュール, Shy, EmoTalk,,1)\nキャラモーション再生(PID_エル, Normal, IdleNormal)\n\n*\nパペット会話中断()\nウェイト(0.5)
MID_RELIANCE_B_#015	キャラモーション再生(PID_リュール, Normal, IdleNormal,,1)
MID_RELIANCE_B_#016	キャラモーション再生(PID_リュール, Normal, EmoRelax,,1)
MID_RELIANCE_B_#017	キャラカメラ(CharaCam_Side_Left4_Mid, PID_エル, cam_anim_pan_l_normal)\n\nキャラモーション再生(PID_エル, Surprise,,,1)\nキャラモーション再生(PID_リュール, Normal, IdleNormal)
MID_RELIANCE_B_#018	キャラカメラ(CharaCam_LowFront_Right, PID_リュール, cam_anim_pan_u_normal)\n\nキャラモーション再生(PID_エル, Sad, IdleNormal)
MID_RELIANCE_B_#019	キャラモーション再生(PID_リュール, Normal, EmoTalk2,,0.5)\nキャラモーション再生(PID_リュール, Normal, EmoRelax, 5,1)
MID_RELIANCE_B_#020	キャラカメラ(CharaCam_Side_Right3_Mid, PID_リュール, cam_anim_zoom_in_normal)\n\nキャラモーション再生(PID_リュール, Sad,,,1)
MID_RELIANCE_B_#021	キャラモーション再生(PID_リュール, Sad, EmoThink,,1)
MID_RELIANCE_B_#022	キャラカメラ(CharaCam_Side_Left4_Mid, PID_エル, cam_anim_track_r_normal)\n\nキャラ視線(PID_エル, PID_デモ用_視線設定用, PID_デモ用_視線設定用)\nキャラモーション再生(PID_リュール, Normal, IdleNormal)
MID_RELIANCE_B_#023	キャラカメラ(CharaCam_FrontLong2_Left_Mid, PID_エル, cam_anim_zoom_in_normal)\n\nキャラ視線(PID_エル, PID_リュール, PID_リュール)\nキャラモーション再生(PID_エル, Die, EmoDeny2,,1)\nキャラモーション再生(PID_エル, Normal,, 4,1)
MID_RELIANCE_B_#024	キャラカメラ(CharaCam_Front_Center2_Mid, PID_リュール, cam_anim_pan_d_normal)\n\nキャラモーション再生(PID_リュール, Smile,,,1)\nキャラモーション再生(PID_リュール, Smile, EmoTalk2, 3,1)\nキャラモーション再生(PID_エル, Normal, IdleNormal)\n*\nフェードアウト()
MID_RELIANCE_A_#001	キャラ配置(PID_エル, ME_IN_C,, Normal, IdleNormal)\nキャラ配置(PID_リュール, YOU_IN_C,, Normal, IdleNormal, -90)\nキャラ配置(PID_エル,,, 0.3)\nキャラ配置(PID_リュール,,, -0.2)\n\nキャラ配置(PID_デモ用_視線設定用, ME_IN_E)\nキャラ表示切替(PID_デモ用_視線設定用, False)\nキャラ配置調整(PID_デモ用_視線設定用,,, 0.8)\n\n背景(Map_Event_Hub_Solanel_06_Day)\nライト(CharaLight_Hub_Day)\n\nキャラ視線(PID_リュール, PID_エル, PID_エル, 3)\nキャラ視線(PID_エル, PID_リュール, PID_リュール)\n\nキャラモーション再生(PID_エル, Normal, WalkIn2)\nウェイト(0.2)\nキャラモーション再生(PID_エル, Normal, EmoTalk2, 3,1)\n\nキャラカメラ(CharaCam_Shoulder_Right_Top, PID_エル, cam_anim_zoom_out_normal)\n\n\nフェードイン()
MID_RELIANCE_A_#002	キャラカメラ(CharaCam_Side_Right2_Mid, PID_リュール, cam_anim_track_r_normal)\n\nキャラ回転(PID_リュール, 20, 0.5)\nキャラモーション再生(PID_リュール, Smile, EmoTalk2,,1)\nキャラモーション再生(PID_エル, Normal, IdleNormal)
MID_RELIANCE_A_#003	キャラ視線(PID_リュール, PID_デモ用_視線設定用, PID_デモ用_視線設定用)\nキャラモーション再生(PID_リュール, Smile, IdleNormal,,1)
MID_RELIANCE_A_#004	キャラ回転(PID_エル, 30, 1)\nキャラ視線(PID_エル, PID_デモ用_視線設定用, PID_デモ用_視線設定用)\nキャラ視線(PID_リュール, PID_エル, PID_エル)\n\nキャラカメラ(CharaCam_Side_Left_Mid, PID_デモ用_視線設定用, cam_anim_pan_r_normal)\nキャラモーション再生(PID_エル, Die, EmoNod,,1)\nキャラモーション再生(PID_エル, Normal, , 5,1)
MID_RELIANCE_A_#005	キャラモーション再生(PID_エル, Die,,,1)\nキャラモーション再生(PID_エル, , EmoPray, 2,0.5)\nキャラ視線(PID_エル, PID_リュール, PID_リュール)\n
MID_RELIANCE_A_#006	キャラモーション再生(PID_エル, Smile,,,1)
MID_RELIANCE_A_#007	キャラカメラ(CharaCam_Side_Right_Mid, PID_リュール, cam_anim_zoom_in_fast)\n\nキャラモーション再生(PID_リュール, Surprise, EmoSurprise,,0.3)\nキャラモーション再生(PID_リュール, Sad,, 3.5,1)\nキャラモーション再生(PID_エル, Normal, IdleNormal)
MID_RELIANCE_A_#008	シーンカメラ(SceneCam_Side_Right_Mid, cam_anim_track3_r_normal)\n\nキャラ視線(PID_エル, PID_リュール, PID_リュール)\nキャラモーション再生(PID_エル, Angry, EmoDeny2,,1)\nキャラモーション再生(PID_エル, Die,, 4,1)\nキャラモーション再生(PID_リュール, Normal, IdleNormal,,1)
MID_RELIANCE_A_#009	キャラモーション再生(PID_エル, Shy,,,1)
MID_RELIANCE_A_#010	キャラモーション再生(PID_リュール, Normal,,,1)
MID_RELIANCE_A_#011	キャラカメラ(CharaCam_SideLong_Left2_Mid, PID_エル, cam_anim_zoom_in_normal)\n\nキャラモーション再生(PID_エル, Die, EmoNod,,1)\nキャラモーション再生(PID_リュール, Normal, IdleNormal)
MID_RELIANCE_A_#012	キャラモーション再生(PID_エル, Normal, EmoRelax,,1)\nキャラモーション再生(PID_エル, Sad, EmoTalk, 4.7,1)
MID_RELIANCE_A_#013	キャラカメラ(CharaCam_LowFront_Right, PID_リュール, cam_anim_pan_u_normal)\n\nキャラモーション再生(PID_リュール, Shy, EmoDeny2,,1)\nキャラモーション再生(PID_エル, Normal, IdleNormal)
MID_RELIANCE_A_#014	キャラモーション再生(PID_リュール, Normal,,,1)
MID_RELIANCE_A_#015	キャラカメラ(CharaCam_Side_Right_Mid, PID_リュール, cam_anim_zoom_in_normal)\n\nキャラモーション再生(PID_リュール, Normal, EmoTalk2,,1)
MID_RELIANCE_A_#016	キャラカメラ(CharaCam_SideLong_Left2_Mid, PID_エル, cam_anim_pan_d_normal)\n\nキャラモーション再生(PID_エル, Smile, EmoDeny2,,1)\nキャラモーション再生(PID_リュール, Normal, IdleNormal)
MID_RELIANCE_A_#017	キャラ回転(PID_エル, -30, 1)\n\nキャラモーション再生(PID_エル, Die,,,1)\nキャラモーション再生(PID_エル, Smile, EmoTalk2, 4.8,1)
MID_RELIANCE_A_#018	キャラカメラ(CharaCam_Front_Center_Mid, PID_エル, cam_anim_zoom_in_normal)\n\nキャラモーション再生(PID_エル, Normal,,,1)\nキャラモーション再生(PID_エル, Smile, EmoRelax, 4,1)
MID_RELIANCE_A_#019	キャラカメラ(CharaCam_SideLong_Right2_Mid, PID_リュール, cam_anim_track_l_normal)\n\nキャラ回転(PID_リュール, 70, 1.4)\nキャラモーション再生(PID_リュール, Smile, TurnR,,1)\nキャラモーション再生(PID_リュール, Smile, EmoTalk2, 2,1)\nキャラモーション再生(PID_エル, Normal, IdleNormal)
MID_RELIANCE_A_#020	キャラモーション再生(PID_リュール, Die, EmoRelax,,1)\nキャラモーション再生(PID_リュール, Normal,, 3,1)
MID_RELIANCE_A_#021	キャラカメラ(CharaCam_Front_Center_Mid, PID_リュール, cam_anim_zoom_in_normal)\n\nキャラモーション再生(PID_リュール, Shy,,,1)
MID_RELIANCE_A_#022	キャラカメラ(CharaCam_SideLong_Left2_Mid, PID_エル, cam_anim_pan_u_normal)\n\nキャラモーション再生(PID_エル, Shy, EmoThink,,1)\nキャラモーション再生(PID_リュール, Normal, IdleNormal)
MID_RELIANCE_A_#023	キャラモーション再生(PID_エル, Smile, EmoJoy,,1)
MID_RELIANCE_A_#024	キャラカメラ(CharaCam_Side_Left3_Top, PID_エル, cam_anim_zoom_in_normal)\n\nキャラモーション再生(PID_エル, Die, EmoNod,,1)\nキャラモーション再生(PID_エル, Smile,, 4.8,1)\n\n*\nフェードアウト()
MID_RELIANCE_S_#001	キャラ配置(PID_エル, YOU_IN_C,, Normal, IdleNormal)\nキャラ配置(PID_リュール, ME_IN_C,, Normal, IdleNormal)\n\n背景(Map_Event_M004_01)\nライト(CharaLight_Hub_Day)\n\nキャラ視線(PID_リュール, PID_エル, PID_エル)\nキャラ視線(PID_エル, PID_リュール, PID_リュール)\n\nキャラモーション再生(PID_エル, Normal, EmoTalk2,,1)\n\nキャラカメラ(CharaCam_FrontLong2_Right_Mid, PID_エル, cam_anim_track_r_normal)\n\n\nフェードイン()
MID_RELIANCE_S_#002	キャラカメラ(CharaCam_Side_Left3_Mid, PID_リュール, cam_anim_pan_d_normal)\n\nキャラモーション再生(PID_リュール, Smile,,,1)\nキャラモーション再生(PID_エル, Normal, IdleNormal)
MID_RELIANCE_S_#003	キャラモーション再生(PID_リュール,, EmoTalk,,1)
MID_RELIANCE_S_#004	キャラカメラ(CharaCam_Side_Right_Mid, PID_エル, cam_anim_pan_r_normal)\n\nキャラモーション再生(PID_エル, Surprise, EmoThink,,0.5)\nキャラモーション再生(PID_リュール, Normal, IdleNormal)
MID_RELIANCE_S_#005	キャラモーション再生(PID_エル, Die, EmoRelax,,0.5)
MID_RELIANCE_S_#006	キャラカメラ(CharaCam_SideLong_Left2_Mid, PID_リュール, cam_anim_zoom_in_normal)\n\nキャラモーション再生(PID_リュール, Normal, EmoTalk2,,1)\nキャラモーション再生(PID_エル, Normal, IdleNormal)
MID_RELIANCE_S_#007	シーンカメラ(SceneCam_SideMe_Right_Mid, cam_anim_track3_r_normal)\n\nキャラモーション再生(PID_エル, Sad, EmoJoy,,1)\nキャラモーション再生(PID_リュール, Normal, IdleNormal,,1)
MID_RELIANCE_S_#008	キャラモーション再生(PID_エル,, EmoTalk,,0.5)
MID_RELIANCE_S_#009	キャラモーション再生(PID_リュール, Surprise,,,1)
MID_RELIANCE_S_#010	キャラカメラ(CharaCam_LowFront_Right, PID_エル, cam_anim_pan_u_normal)\n\nキャラモーション再生(PID_エル, Die, EmoDeny2,,1)\nキャラモーション再生(PID_エル, Sad,, 5,1)\nキャラモーション再生(PID_リュール, Normal, IdleNormal)
MID_RELIANCE_S_#011	キャラモーション再生(PID_エル, Sad, EmoPray,,0.5)
MID_RELIANCE_S_#012	キャラカメラ(CharaCam_FrontLong2_Left_Mid, PID_リュール, cam_anim_zoom_in_normal)\n\nキャラモーション再生(PID_リュール, Smile,,,1)\nキャラモーション再生(PID_エル, Normal, IdleNormal)
MID_RELIANCE_S_#013	キャラモーション再生(PID_リュール, Smile, EmoDeny, ,1)
MID_RELIANCE_S_#014	キャラカメラ(CharaCam_Side_Left2_Mid, PID_リュール, cam_anim_track_r_normal)\n\nキャラモーション再生(PID_リュール, Smile, EmoJoy, 1.5,1)
MID_RELIANCE_S_#015	キャラモーション再生(PID_リュール, Die, EmoThink, ,1)\nキャラモーション再生(PID_リュール, Smile,, 4,1)
MID_RELIANCE_S_#016	キャラカメラ(CharaCam_SideLong_Right2_Mid, PID_エル, cam_anim_pan_u_normal)\n\nキャラモーション再生(PID_エル, Smile, EmoRelax,,1)\nキャラモーション再生(PID_エル, Smile,, 4,1)\nキャラモーション再生(PID_リュール, Normal, IdleNormal)
MID_RELIANCE_S_#017	キャラモーション再生(PID_エル, Normal, EmoThink,,1)
MID_RELIANCE_S_#018	キャラモーション再生(PID_エル, Smile,, ,1)\nキャラモーション再生(PID_エル, Smile, EmoTalk, 3,1)
MID_RELIANCE_S_#019	キャラカメラ(CharaCam_Side_Left3_Mid, PID_リュール, cam_anim_pan_l_normal)\n\nキャラモーション再生(PID_リュール, Smile, EmoNod,,1)\nキャラモーション再生(PID_エル, Normal, IdleNormal)
MID_RELIANCE_S_#020	キャラカメラ(CharaCam_Side_Right3_Mid, PID_エル, cam_anim_zoom_in_normal)\n\nキャラモーション再生(PID_エル, Sad, EmoPray,,1)\nキャラモーション再生(PID_リュール, Normal, IdleNormal)\n
MID_RELIANCE_S_#021	キャラモーション待ち(PID_エル)\n\nキャラモーション再生(PID_エル, Normal, IdleNormal,,1)\nキャラモーション再生(PID_エル, Normal, EmoTalk2, 3,1)
MID_RELIANCE_S_#022	キャラカメラ(CharaCam_FrontLong2_Left_Mid, PID_リュール, cam_anim_track_l_normal)\n\nキャラモーション再生(PID_リュール, Die, EmoRelax,,1)\nキャラモーション再生(PID_リュール, Shy, EmoTalk, 4.3,1)\nキャラモーション再生(PID_エル, Normal, IdleNormal,,1)
MID_RELIANCE_S_#023	キャラモーション再生(PID_リュール, Smile,,,1)\nキャラモーション再生(PID_リュール, Shy, EmoGive, 5,1)\n\n*\nパペット会話中断()\n\n一枚絵表示(Tex_Event_ItemPicture_14, picture_item_fade_in_normal)\n\nシーンカメラ(SceneCam_SideMe_Right_Mid, cam_anim_zoom_in_normal)\n\nウェイト(1)
MID_RELIANCE_S_#024	キャラモーション再生(PID_エル, Surprise, EmoSurprise,,1)\n\n*\nパペット会話中断()\n\n一枚絵非表示(picture_item_fade_out_normal)\n\nウェイト(1)
MID_RELIANCE_S_#025	キャラカメラ(CharaCam_Front_Center2_Mid, PID_リュール, cam_anim_zoom_in_normal)\n\nキャラモーション再生(PID_リュール, Normal, EmoPray,,1)\nキャラモーション再生(PID_リュール, Shy,, 5,1)\nキャラモーション再生(PID_エル, Normal, IdleNormal)
MID_RELIANCE_S_#026	キャラカメラ(CharaCam_Side_Right2_Mid, PID_エル, cam_anim_pan_r_normal)\n\nキャラモーション再生(PID_エル, Surprise,,,1)\nキャラモーション再生(PID_リュール, Normal, IdleNormal)\n\n*\nパペット会話中断()\nウェイト(0.5)
MID_RELIANCE_S_#027	キャラカメラ(CharaCam_SideLong_Left2_Mid, PID_リュール, cam_anim_track3_l_normal)\n\nキャラモーション再生(PID_リュール, Die, EmoRelax,,1)\nキャラモーション再生(PID_リュール, Normal, EmoDeny2, 5,1)\nキャラモーション再生(PID_エル, Normal, IdleNormal)\nキャラ表示切替(PID_エル, False)
MID_RELIANCE_S_#028	キャラモーション再生(PID_リュール, Smile, EmoTalk,,1)
MID_RELIANCE_S_#029	キャラカメラ(CharaCam_Side_Left_Mid, PID_リュール, cam_anim_pan_l_normal)\n\nキャラモーション再生(PID_リュール, Normal, EmoRelax,,1)
MID_RELIANCE_S_#030	キャラモーション再生(PID_リュール, Smile, EmoTalk2,,1)
MID_RELIANCE_S_#031	キャラ表示切替(PID_エル, True)\nキャラカメラ(CharaCam_SideLong_Right2_Mid, PID_エル, cam_anim_pan_d_normal)\n\nキャラモーション再生(PID_エル, Shy, EmoRelax,,1)\nキャラモーション再生(PID_エル, Sad, EmoSad, 5,0.5)\nキャラモーション再生(PID_リュール, Normal, IdleNormal)\n
MID_RELIANCE_S_#032	キャラモーション再生(PID_エル, Shy, EmoShy,,1)\nキャラモーション再生(PID_エル, Shy, EmoTalk, 5,1)\n
MID_RELIANCE_S_#033	キャラカメラ(CharaCam_Side_Right2_Mid, PID_エル, cam_anim_zoom_in_normal)\n\nキャラモーション再生(PID_エル, Smile, EmoJoy,,1)\n
MID_RELIANCE_S_#034	キャラカメラ(CharaCam_Side_Left3_Mid, PID_リュール, cam_anim_pan_l_normal)\n\nキャラモーション再生(PID_リュール, Smile,,,1)\nキャラモーション再生(PID_エル, Normal, IdleNormal)
MID_RELIANCE_S_#035	キャラカメラ(CharaCam_Front_Center2_Mid, PID_エル, cam_anim_zoom_in_normal)\n\nキャラモーション再生(PID_エル, Die, EmoRelax,,1)\nキャラモーション再生(PID_エル, Shy,, 5,1)\nキャラモーション再生(PID_リュール, Normal, IdleNormal)\n*\n\nパペット会話中断()
MID_RELIANCE_S_#036	フェードアウト()\n一枚絵表示(Tex_Event_DLC_Reliance_S_01)\nウェイト(0.8)\n\nフェードイン()\nウェイト(1.2)\n\n*\n\nウェイト(1)\nフェードアウト()
