MID_RELIANCE_C_#001	キャラ配置(PID_リュール, ME_IN_C, [服装], Normal, IdleNormal, 0)\nキャラ配置(PID_セリーヌ, YOU_IN_C, [服装], Normal, IdleNormal, 0)\n\n背景(Map_Event_Hub_Solanel_01_Day)\nライト(CharaLight_Hub_Day, 0, 0, 0)\n\nキャラ視線(PID_リュール, PID_セリーヌ, PID_セリーヌ)\nキャラ視線(PID_セリーヌ, PID_リュール, PID_リュール)\n\nウェイト(1)\n\nキャラモーション再生(PID_リュール, Smile, EmoRelax)\n\nキャラカメラ(CharaCam_FrontLong2_Left_Mid, PID_リュール, cam_anim_track2_l_normal)\n\nフェードイン()
MID_RELIANCE_C_#002	キャラモーション再生(PID_セリーヌ, Smile, EmoDeny,, 0.3)\nキャラモーション再生(PID_リュール, Smile, IdleNormal)\n\nキャラカメラ(CharaCam_Side_Right2_Mid, PID_セリーヌ, cam_anim_track_l_slow)
MID_RELIANCE_C_#003	
MID_RELIANCE_C_#004	キャラモーション再生(PID_セリーヌ, Smile, IdleNormal)\n\nキャラカメラ(CharaCam_Side_Left2_Mid, PID_リュール, cam_anim_track_r_normal)
MID_RELIANCE_C_#005	キャラモーション再生(PID_セリーヌ, Smile, EmoRelax)\n\nキャラカメラ(CharaCam_Shoulder_Right_Mid, PID_リュール, cam_anim_pan_d_slow)
MID_RELIANCE_C_#006	キャラモーション再生(PID_リュール, Smile, IdleNormal)\n\nキャラカメラ(CharaCam_SideLong_Right2_Mid, PID_セリーヌ, cam_anim_pan_u_slow)
MID_RELIANCE_C_#007	キャラモーション再生(PID_セリーヌ, Smile, EmoTalk2,, 1)
MID_RELIANCE_C_#008	キャラモーション再生(PID_セリーヌ, Smile, IdleNormal)\n\nキャラカメラ(CharaCam_Side_Left2_Mid, PID_リュール, cam_anim_track_r_slow)
MID_RELIANCE_C_#009	キャラモーション再生(PID_リュール, Smile, EmoTalk,, 0.3)
MID_RELIANCE_C_#010	キャラモーション再生(PID_セリーヌ, Relax)\n\nキャラカメラ(CharaCam_Shoulder_Right_Mid, PID_リュール, cam_anim_pan_d_normal)
MID_RELIANCE_C_#011	キャラモーション再生(PID_セリーヌ, Die)\nキャラモーション再生(PID_リュール, Smile, IdleNormal)\n\nキャラカメラ(CharaCam_Front_Center_Top, PID_セリーヌ, cam_anim_pan_u_slow)
MID_RELIANCE_C_#012	
MID_RELIANCE_C_#013	キャラモーション再生(PID_セリーヌ, Shy, EmoThink)\n\nキャラカメラ(CharaCam_SideLong_Right2_Mid, PID_セリーヌ, cam_anim_pan_u_slow)
MID_RELIANCE_C_#014	
MID_RELIANCE_C_#015	キャラモーション再生(PID_セリーヌ, Shy, IdleNormal)\n\nキャラカメラ(CharaCam_Front_Center2_Mid, PID_リュール, cam_anim_pan_d_normal)
MID_RELIANCE_C_#016	キャラモーション再生(PID_リュール, Smile, EmoTalk,, 0.3)
MID_RELIANCE_C_#017	キャラモーション再生(PID_セリーヌ, Smile, EmoRelax)\n\nキャラカメラ(CharaCam_Front_Center_Top, PID_セリーヌ, cam_anim_pan_u_normal)\n\n*\n\nフェードアウト()
MID_RELIANCE_B_#001	キャラ配置(PID_リュール, YOU_IN_C, [服装], Normal, IdleNormal, 0)\nキャラ配置(PID_セリーヌ, ME_IN_C, [服装], Normal, IdleNormal, 0)\nキャラ配置(PID_デモ用_視線設定用, ME_IN_A, [服装], Normal, IdleNormal, 0)\n\nキャラ配置調整(PID_セリーヌ, 0, 0, 0, -40)\nキャラ配置調整(PID_デモ用_視線設定用, 0, -1, 0.3, 0)\n\nキャラ視線(PID_リュール, PID_セリーヌ, PID_セリーヌ)\nキャラ視線(PID_セリーヌ, PID_デモ用_視線設定用, PID_デモ用_視線設定用)\n\n背景(Map_Event_Hub_Solanel_05_Day)\nライト(CharaLight_Hub_Day, 0, 0, 0)\n\nキャラモーション再生(PID_セリーヌ, Die, EmoThinkLoop)\n\nウェイト(1)\n\nキャラカメラ(CharaCam_SideLong_Right2_Mid, PID_セリーヌ, cam_anim_pan_u_normal)\n\nウェイト(1)\n\nフェードイン()
MID_RELIANCE_B_#002	キャラモーション再生(PID_リュール, Normal, WalkIn2)\n\nキャラカメラ(CharaCam_Shoulder_Left_Bot, PID_セリーヌ, cam_anim_track2_l_normal)
MID_RELIANCE_B_#003	キャラモーション再生(PID_セリーヌ, Sad, EmoTalk2,, 1)\nキャラ回転(PID_セリーヌ, 40, 1.5)\n\nキャラ視線(PID_セリーヌ, PID_リュール, PID_デモ用_視線設定用)\n\nキャラカメラ(CharaCam_Shoulder_Right_Mid, PID_リュール, cam_anim_pan_d_normal)
MID_RELIANCE_B_#004	キャラモーション再生(PID_リュール, Smile, EmoNod)\nキャラモーション再生(PID_セリーヌ, Sad, IdleNormal)\n\nキャラ視線(PID_セリーヌ, PID_リュール, PID_リュール)\n\nキャラカメラ(CharaCam_Side_Left2_Mid, PID_リュール, cam_anim_track_r_normal)
MID_RELIANCE_B_#005	キャラモーション再生(PID_セリーヌ, Sad, EmoThink)\nキャラモーション再生(PID_リュール, Smile, IdleNormal)\n\nキャラカメラ(CharaCam_Side_Right2_Mid, PID_セリーヌ, cam_anim_track_l_slow)
MID_RELIANCE_B_#006	
MID_RELIANCE_B_#007	キャラモーション再生(PID_リュール, Sad)\nキャラモーション再生(PID_セリーヌ, Sad, IdleNormal)\n\nキャラカメラ(CharaCam_Side_Left3_Mid, PID_リュール, cam_anim_pan_d_normal)
MID_RELIANCE_B_#008	キャラモーション再生(PID_セリーヌ, Sad, EmoDeny2)\n\nキャラカメラ(CharaCam_Shoulder_Right_Mid, PID_リュール, cam_anim_pan_d_normal)
MID_RELIANCE_B_#009	キャラカメラ(CharaCam_Front_Center_Mid, PID_セリーヌ, cam_anim_zoom_out_slow)
MID_RELIANCE_B_#010	キャラモーション再生(PID_セリーヌ, Sad, EmoTalk2,, 1)
MID_RELIANCE_B_#011	キャラモーション再生(PID_リュール, Normal)\nキャラモーション再生(PID_セリーヌ, Sad, IdleNormal)\n\nキャラカメラ(CharaCam_Front_Center_Top, PID_リュール, cam_anim_pan_u_normal)
MID_RELIANCE_B_#012	キャラカメラ(CharaCam_Side_Right2_Mid, PID_セリーヌ, cam_anim_track_l_slow)
MID_RELIANCE_B_#013	キャラモーション再生(PID_セリーヌ, Die, EmoThink,, 0.3)
MID_RELIANCE_B_#014	キャラモーション再生(PID_リュール, Normal, EmoTalk)\nキャラモーション再生(PID_セリーヌ, Die, IdleNormal)\n\nキャラカメラ(CharaCam_Side_Left2_Mid, PID_リュール, cam_anim_track_r_normal)
MID_RELIANCE_B_#015	キャラモーション再生(PID_セリーヌ, Normal, EmoTalk2)\nキャラモーション再生(PID_リュール, Normal, IdleNormal,, 1)\n\nシーンカメラ(SceneCam_SideYou_Left_Mid, cam_anim_zoom_in_slow)
MID_RELIANCE_B_#016	キャラモーション再生(PID_セリーヌ, Sad)
MID_RELIANCE_B_#017	キャラモーション再生(PID_セリーヌ, Angry, EmoDeny,, 1)\nキャラモーション再生(PID_リュール, Normal, IdleNormal)\n\nキャラカメラ(CharaCam_Front_Center_Top, PID_セリーヌ, cam_anim_pan_u_normal)
MID_RELIANCE_B_#018	キャラモーション再生(PID_リュール, Sad)\nキャラモーション再生(PID_セリーヌ, Angry, IdleNormal)\n\nキャラカメラ(CharaCam_Side_Left2_Mid, PID_リュール, cam_anim_track_r_normal)
MID_RELIANCE_B_#019	キャラカメラ(CharaCam_Side_Right2_Mid, PID_セリーヌ, cam_anim_track_l_slow)
MID_RELIANCE_B_#020	キャラモーション再生(PID_セリーヌ, Angry, EmoProud,, 1)
MID_RELIANCE_B_#021	キャラモーション再生(PID_セリーヌ, Angry, IdleNormal)\n\nキャラカメラ(CharaCam_Front_Center_Mid, PID_リュール, cam_anim_zoom_in_normal)
MID_RELIANCE_B_#022	キャラモーション再生(PID_セリーヌ, Sad, EmoRelax)\n\nキャラカメラ(CharaCam_SideLong_Right2_Mid, PID_セリーヌ, cam_anim_pan_u_slow)
MID_RELIANCE_B_#023	キャラモーション再生(PID_セリーヌ, Die)\n\n*\n\nフェードアウト()
MID_RELIANCE_A_#001	キャラ配置(PID_リュール, ME_IN_C, [服装], Normal, IdleNormal, 0)\nキャラ配置(PID_セリーヌ, YOU_IN_C, [服装], Normal, IdleNormal, 0)\n\n背景(Map_Event_Hub_Solanel_01_Day)\nライト(CharaLight_Hub_Day, 0, 0, 0)\n\nキャラ視線(PID_リュール, PID_セリーヌ, PID_セリーヌ)\nキャラ視線(PID_セリーヌ, PID_リュール, PID_リュール)\n\nウェイト(1)\n\nキャラモーション再生(PID_セリーヌ, Normal, EmoRelax)\n\nキャラカメラ(CharaCam_Side_Right2_Top, PID_セリーヌ, cam_anim_track_l_normal)\n\nフェードイン()
MID_RELIANCE_A_#002	キャラモーション再生(PID_セリーヌ, Normal, IdleNormal)\n\nキャラカメラ(CharaCam_Side_Left2_Mid, PID_リュール, cam_anim_track_r_normal)
MID_RELIANCE_A_#003	キャラカメラ(CharaCam_Shoulder_Right_Mid, PID_リュール, cam_anim_pan_d_slow)
MID_RELIANCE_A_#004	キャラモーション再生(PID_セリーヌ, Normal, EmoTalk2,, 0.3)
MID_RELIANCE_A_#005	キャラカメラ(CharaCam_Front_Center_Top, PID_セリーヌ, cam_anim_pan_u_normal)
MID_RELIANCE_A_#006	キャラモーション再生(PID_リュール, Die)\nキャラモーション再生(PID_セリーヌ, Sad, IdleNormal)\n\nキャラカメラ(CharaCam_Side_Left2_Mid, PID_リュール, cam_anim_track_r_normal)
MID_RELIANCE_A_#007	キャラモーション再生(PID_セリーヌ, Die, EmoThink)\n\nキャラカメラ(CharaCam_Side_Right2_Top, PID_セリーヌ, cam_anim_track_l_slow)
MID_RELIANCE_A_#008	キャラモーション再生(PID_セリーヌ, Angry)
MID_RELIANCE_A_#009	
MID_RELIANCE_A_#010	キャラモーション再生(PID_リュール, Sad)\nキャラモーション再生(PID_セリーヌ, Angry, IdleNormal)\n\nキャラカメラ(CharaCam_Front_Center_Mid, PID_リュール, cam_anim_zoom_in_normal)
MID_RELIANCE_A_#011	キャラモーション再生(PID_セリーヌ, Die)\n\nキャラカメラ(CharaCam_Side_Right2_Top, PID_セリーヌ, cam_anim_zoom_in_slow)
MID_RELIANCE_A_#012	キャラモーション再生(PID_セリーヌ, Die, EmoSad2,, 0.3)
MID_RELIANCE_A_#013	キャラモーション再生(PID_リュール, Sad, EmoDeny2, 5, 0.3)\n\nキャラカメラ(CharaCam_Shoulder_Left_Bot, PID_セリーヌ, cam_anim_track2_l_normal)
MID_RELIANCE_A_#014	キャラモーション再生(PID_セリーヌ, Shy)\nキャラモーション再生(PID_リュール, Sad, IdleNormal)\n\nキャラカメラ(CharaCam_Front_Center_Top, PID_セリーヌ, cam_anim_pan_u_normal)
MID_RELIANCE_A_#015	キャラモーション再生(PID_セリーヌ, Normal)\n\nキャラカメラ(CharaCam_Shoulder_Right_Mid, PID_リュール, cam_anim_pan_d_slow)
MID_RELIANCE_A_#016	
MID_RELIANCE_A_#017	キャラモーション再生(PID_セリーヌ, Sad)\n\nキャラカメラ(CharaCam_Side_Right2_Top, PID_セリーヌ, cam_anim_track_l_slow)
MID_RELIANCE_A_#018	キャラモーション再生(PID_セリーヌ, Sad, EmoDeny,, 1)\n
MID_RELIANCE_A_#019	
MID_RELIANCE_A_#020	キャラモーション再生(PID_リュール, Smile, EmoTalk)\nキャラモーション再生(PID_セリーヌ, Die, IdleNormal)\n\nキャラカメラ(CharaCam_Front_Center_Mid, PID_リュール, cam_anim_zoom_out_slow)
MID_RELIANCE_A_#021	
MID_RELIANCE_A_#022	キャラモーション再生(PID_セリーヌ, Shy, EmoRelax)\nキャラモーション再生(PID_リュール, Smile, IdleNormal)\n\nキャラカメラ(CharaCam_SideLong_Right2_Mid, PID_セリーヌ, cam_anim_pan_u_normal)\n\n*\n\nフェードアウト()
MID_RELIANCE_S_#001	キャラ配置(PID_リュール, ME_IN_C, [服装], Normal, IdleNormal, 0)\nキャラ配置(PID_セリーヌ, YOU_IN_C, [服装], Normal, IdleNormal, 0)\n\n背景(Map_Event_Hub_Solanel_06_Day)\nライト(CharaLight_Hub_Day, 0, 0, 0)\n\nキャラ視線(PID_リュール, PID_セリーヌ, PID_セリーヌ)\nキャラ視線(PID_セリーヌ, PID_リュール, PID_リュール)\n\nウェイト(1)\n\nキャラモーション再生(PID_セリーヌ, Normal, EmoRelax)\n\nキャラカメラ(CharaCam_Shoulder_Right_Mid, PID_リュール, cam_anim_pan_d_normal)\n\nフェードイン()
MID_RELIANCE_S_#002	キャラモーション再生(PID_リュール, Relax)\nキャラモーション再生(PID_セリーヌ, Normal, IdleNormal)\n\nキャラカメラ(CharaCam_Front_Center_Top, PID_リュール, cam_anim_pan_u_normal)
MID_RELIANCE_S_#003	キャラモーション再生(PID_セリーヌ, Normal, EmoTalk2)\n\nキャラカメラ(CharaCam_Side_Right2_Mid, PID_セリーヌ, cam_anim_track_l_slow)
MID_RELIANCE_S_#004	
MID_RELIANCE_S_#005	キャラカメラ(CharaCam_Front_Center_Top, PID_セリーヌ, cam_anim_pan_u_normal)
MID_RELIANCE_S_#006	キャラモーション再生(PID_リュール, Normal, EmoNod)\nキャラモーション再生(PID_セリーヌ, Normal, IdleNormal)\n\nキャラカメラ(CharaCam_Side_Left2_Mid, PID_リュール, cam_anim_track_r_normal)
MID_RELIANCE_S_#007	キャラモーション再生(PID_セリーヌ, Sad)\nキャラモーション再生(PID_リュール, Normal, IdleNormal)\n\nキャラカメラ(CharaCam_Side_Right2_Mid, PID_セリーヌ, cam_anim_track_l_slow)
MID_RELIANCE_S_#008	キャラモーション再生(PID_セリーヌ, Sad, EmoSad,, 0.3)
MID_RELIANCE_S_#009	キャラモーション再生(PID_リュール, Sad, EmoRelax)\nキャラモーション再生(PID_セリーヌ, Sad, IdleNormal)\n\nキャラカメラ(CharaCam_Side_Left2_Mid, PID_リュール, cam_anim_track_r_normal)
MID_RELIANCE_S_#010	キャラモーション再生(PID_セリーヌ, Sad, EmoDeny,, 0.3)\nキャラモーション再生(PID_リュール, Sad, IdleNormal)\n\nキャラカメラ(CharaCam_SideLong_Right2_Mid, PID_セリーヌ, cam_anim_pan_u_slow)
MID_RELIANCE_S_#011	キャラモーション再生(PID_セリーヌ, Die)
MID_RELIANCE_S_#012	キャラモーション再生(PID_セリーヌ, Die, IdleNormal)\n\nキャラカメラ(CharaCam_Side_Left2_Mid, PID_リュール, cam_anim_track_r_normal)
MID_RELIANCE_S_#013	キャラモーション再生(PID_セリーヌ, Sad, EmoTalk,, 1)\n\nキャラカメラ(CharaCam_Shoulder_Right_Mid, PID_リュール, cam_anim_pan_d_slow)
MID_RELIANCE_S_#014	
MID_RELIANCE_S_#015	キャラモーション再生(PID_セリーヌ, Sad, EmoRelax,, 1)\n\nキャラカメラ(CharaCam_Front_Center_Mid, PID_セリーヌ, cam_anim_zoom_out_normal)
MID_RELIANCE_S_#016	キャラモーション再生(PID_リュール, Die)\nキャラモーション再生(PID_セリーヌ, Sad, IdleNormal)\n\nキャラカメラ(CharaCam_Side_Left_Mid, PID_リュール, cam_anim_track_r_slow)
MID_RELIANCE_S_#017	キャラモーション再生(PID_リュール, Normal, EmoGive,, 0.3)\n\n*\n\nパペット会話中断()\n\n一枚絵表示(Tex_Event_ItemPicture_14, picture_item_fade_in_normal)\n\nキャラカメラ(CharaCam_SideLong_Right_Mid, PID_セリーヌ, cam_anim_track_l_normal)\n\nキャラモーション再生(PID_リュール, Normal, IdleNormal)\n\nウェイト(1)
MID_RELIANCE_S_#018	キャラモーション再生(PID_セリーヌ, Surprise, EmoSurprise,, 0.3)\n\n*\n\nパペット会話中断()\n\n一枚絵非表示(picture_item_fade_out_normal)\n\nウェイト(1)
MID_RELIANCE_S_#019	キャラモーション再生(PID_リュール, Smile, EmoDeny2)\nキャラモーション再生(PID_セリーヌ, Surprise, IdleNormal)\n\nキャラカメラ(CharaCam_Front_Center_Mid, PID_リュール, cam_anim_zoom_out_slow)
MID_RELIANCE_S_#020	
MID_RELIANCE_S_#021	キャラモーション再生(PID_リュール, Smile, EmoTalk2,, 1)
MID_RELIANCE_S_#022	キャラモーション再生(PID_セリーヌ, Sad, EmoSad2)\nキャラモーション再生(PID_リュール, Smile, IdleNormal)\n\nキャラカメラ(CharaCam_SideLong_Right2_Mid, PID_セリーヌ, cam_anim_pan_u_normal)
MID_RELIANCE_S_#023	キャラモーション再生(PID_セリーヌ, Sad, IdleNormal)\n\nキャラカメラ(CharaCam_Front_Center_Mid, PID_リュール, cam_anim_zoom_in_slow)
MID_RELIANCE_S_#024	キャラモーション再生(PID_リュール, Smile, EmoRelax,, 0.3)
MID_RELIANCE_S_#025	キャラモーション再生(PID_セリーヌ, Shy)\nキャラモーション再生(PID_リュール, Smile, IdleNormal,, 1)\n\nキャラカメラ(CharaCam_Shoulder_Right_Mid, PID_リュール, cam_anim_pan_d_normal)
MID_RELIANCE_S_#026	キャラカメラ(CharaCam_Front_Center_Top, PID_セリーヌ, cam_anim_pan_u_normal)
MID_RELIANCE_S_#027	キャラモーション再生(PID_セリーヌ, Shy, EmoPray,, 0.3)\n\n*\n\nパペット会話中断()
MID_RELIANCE_S_#028	フェードアウト()\n一枚絵表示(Tex_Event_Reliance_S_07)\nウェイト(0.8)\n\nフェードイン()\nウェイト(1.2)\n\n*\n\nウェイト(1)\nフェードアウト()
