MID_RELIANCE_C_#001	キャラ配置(PID_リュール, ME_IN_C, [服装], Normal, IdleNormal, 0)\nキャラ配置(PID_アルフレッド, YOU_IN_C, [服装], Normal, IdleNormal, 0)\n\n背景(Map_Event_Hub_Solanel_03_Day)\nライト(CharaLight_Hub_Day, 0, 0, 0)\n\nキャラ視線(PID_リュール, PID_アルフレッド, PID_アルフレッド)\nキャラ視線(PID_アルフレッド, PID_リュール, PID_リュール)\n\nウェイト(1)\n\nキャラモーション再生(PID_アルフレッド, Smile, WalkIn2)\n\nキャラカメラ(CharaCam_Shoulder_Right_Mid, PID_リュール, cam_anim_track2_r_normal)\n\nフェードイン()
MID_RELIANCE_C_#002	キャラモーション再生(PID_リュール, Smile)\n\nキャラカメラ(CharaCam_Side_Left2_Mid, PID_リュール, cam_anim_track_r_slow)
MID_RELIANCE_C_#003	キャラモーション再生(PID_リュール, Smile, EmoTalk,, 0.3)
MID_RELIANCE_C_#004	キャラモーション再生(PID_アルフレッド, Smile, EmoNod)\nキャラモーション再生(PID_リュール, Smile, IdleNormal)\n\nキャラカメラ(CharaCam_Side_Right2_Mid, PID_アルフレッド, cam_anim_track_l_slow)
MID_RELIANCE_C_#005	
MID_RELIANCE_C_#006	キャラモーション再生(PID_アルフレッド, Smile, EmoTalk2,, 1)\n\nキャラカメラ(CharaCam_Shoulder_Right_Mid, PID_リュール, cam_anim_zoom_in_normal)
MID_RELIANCE_C_#007	キャラモーション再生(PID_リュール, Shy, EmoDeny)\nキャラモーション再生(PID_アルフレッド, Smile, IdleNormal)\n\nキャラカメラ(CharaCam_Front_Center_Mid, PID_リュール, cam_anim_zoom_in_normal)
MID_RELIANCE_C_#008	キャラモーション再生(PID_アルフレッド, Smile, EmoJoy)\nキャラモーション再生(PID_リュール, Shy, IdleNormal)\n\nキャラカメラ(CharaCam_Front_Center_Top, PID_アルフレッド, cam_anim_zoom_out_normal)
MID_RELIANCE_C_#009	キャラモーション再生(PID_リュール, Smile, EmoNod)\nキャラモーション再生(PID_アルフレッド, Smile, IdleNormal)\n\nキャラカメラ(CharaCam_Side_Left2_Mid, PID_リュール, cam_anim_track_r_normal)
MID_RELIANCE_C_#010	キャラモーション再生(PID_リュール, Smile, IdleNormal)\n\nキャラカメラ(CharaCam_Side_Right2_Mid, PID_アルフレッド, cam_anim_track_l_slow)
MID_RELIANCE_C_#011	キャラモーション再生(PID_アルフレッド, Relax, EmoThink,, 0.3)
MID_RELIANCE_C_#012	
MID_RELIANCE_C_#013	キャラモーション再生(PID_リュール, Relax, EmoThink)\nキャラモーション再生(PID_アルフレッド, Relax, IdleNormal)\n\nキャラカメラ(CharaCam_Front_Center_Top, PID_リュール, cam_anim_zoom_out_normal)
MID_RELIANCE_C_#014	キャラモーション再生(PID_アルフレッド, Smile)\nキャラモーション再生(PID_リュール, Relax, IdleNormal)\n\nキャラカメラ(CharaCam_Side_Right2_Mid, PID_アルフレッド, cam_anim_track_l_normal)
MID_RELIANCE_C_#015	キャラカメラ(CharaCam_Shoulder_Right_Mid, PID_リュール, cam_anim_zoom_in_slow)
MID_RELIANCE_C_#016	
MID_RELIANCE_C_#017	キャラモーション再生(PID_リュール, Smile, EmoRelax)\n\nキャラカメラ(CharaCam_Front_Center_Top, PID_リュール, cam_anim_pan_u_normal)\n\n*\n\nフェードアウト()
MID_RELIANCE_B_#001	キャラ配置(PID_リュール, ME_IN_C, [服装], Normal, IdleNormal, 0)\nキャラ配置(PID_アルフレッド, YOU_IN_C, [服装], Normal, IdleNormal, 0)\n\n背景(Map_Event_Hub_Solanel_07_Day)\nライト(CharaLight_Hub_Day, 0, 0, 0)\n\nキャラ視線(PID_リュール, PID_アルフレッド, PID_アルフレッド)\nキャラ視線(PID_アルフレッド, PID_リュール, PID_リュール)\n\nウェイト(1)\n\nキャラモーション再生(PID_リュール, Normal, EmoTalk)\n\nキャラカメラ(CharaCam_Shoulder_Left_Top, PID_アルフレッド, cam_anim_track2_l_normal)\n\nフェードイン()
MID_RELIANCE_B_#002	キャラモーション再生(PID_アルフレッド, Smile, EmoNod,, 0.3)\nキャラモーション再生(PID_リュール, Normal, IdleNormal)\n\nキャラカメラ(CharaCam_Side_Right2_Mid, PID_アルフレッド, cam_anim_track_l_normal)
MID_RELIANCE_B_#003	キャラモーション再生(PID_リュール, Die)\nキャラモーション再生(PID_アルフレッド, Smile, IdleNormal)\n\nキャラカメラ(CharaCam_Side_Left2_Mid, PID_リュール, cam_anim_track_r_normal)
MID_RELIANCE_B_#004	キャラモーション再生(PID_リュール, Sad)
MID_RELIANCE_B_#005	キャラモーション再生(PID_アルフレッド, Surprise, EmoSurprise)\n\nキャラカメラ(CharaCam_Front_Center_Top, PID_アルフレッド, cam_anim_zoom_out_normal)
MID_RELIANCE_B_#006	キャラモーション再生(PID_リュール, Sad, EmoDeny2, 3, 0.3)\nキャラモーション再生(PID_アルフレッド, Surprise, IdleNormal)\n\nキャラカメラ(CharaCam_Side_Left2_Mid, PID_リュール, cam_anim_track_r_normal)
MID_RELIANCE_B_#007	キャラモーション再生(PID_リュール, Sad, EmoTalk,, 1)
MID_RELIANCE_B_#008	キャラモーション再生(PID_アルフレッド, Sad, EmoSad)\nキャラモーション再生(PID_リュール, Sad, IdleNormal)\n\nキャラカメラ(CharaCam_Side_Right2_Mid, PID_アルフレッド, cam_anim_track_l_slow)
MID_RELIANCE_B_#009	
MID_RELIANCE_B_#010	キャラモーション再生(PID_リュール, Shy)\nキャラモーション再生(PID_アルフレッド, Sad, IdleNormal,, 1)\n\nシーンカメラ(SceneCam_SideYou_Right_Mid, cam_anim_zoom_in_slow)
MID_RELIANCE_B_#011	キャラモーション再生(PID_リュール, Sad, EmoThink,, 0.3)
MID_RELIANCE_B_#012	キャラモーション再生(PID_アルフレッド, Smile, EmoTalk2)\nキャラモーション再生(PID_リュール, Sad, IdleNormal)\n\nキャラカメラ(CharaCam_Side_Right2_Mid, PID_アルフレッド, cam_anim_track_l_normal)
MID_RELIANCE_B_#013	キャラモーション再生(PID_アルフレッド, Smile, IdleNormal)\n\nキャラカメラ(CharaCam_Side_Left2_Mid, PID_リュール, cam_anim_track_r_normal)
MID_RELIANCE_B_#014	キャラカメラ(CharaCam_Shoulder_Left_Top, PID_アルフレッド, cam_anim_track2_l_normal)
MID_RELIANCE_B_#015	キャラモーション再生(PID_リュール, Die, EmoSad,, 0.3)
MID_RELIANCE_B_#016	キャラモーション再生(PID_アルフレッド, Surprise)\nキャラモーション再生(PID_リュール, Die, IdleNormal)\n\nキャラカメラ(CharaCam_Front_Center_Mid, PID_アルフレッド, cam_anim_zoom_in_slow)
MID_RELIANCE_B_#017	キャラモーション再生(PID_アルフレッド, Sad, EmoSad2,, 0.3)
MID_RELIANCE_B_#018	
MID_RELIANCE_B_#019	キャラモーション再生(PID_リュール, Surprise)\nキャラモーション再生(PID_アルフレッド, Sad, IdleNormal)\n\nキャラ視線リセット(PID_アルフレッド)\n\nキャラカメラ(CharaCam_Side_Left2_Mid, PID_リュール, cam_anim_track_r_normal)
MID_RELIANCE_B_#020	キャラモーション再生(PID_リュール, Sad)\n\nキャラカメラ(CharaCam_Side_Right2_Mid, PID_アルフレッド, cam_anim_track_l_normal)
MID_RELIANCE_B_#021	キャラモーション再生(PID_アルフレッド, Sad, TurnL)\n\nキャラ回転(PID_アルフレッド, 190, 1.5)\n\nキャラカメラ(CharaCam_ShoulderLong_Left_Top, PID_アルフレッド, cam_anim_zoom_in_normal)\n\n*\n\nキャラモーション再生(PID_アルフレッド, Sad, RunOut,, 1)\n\nウェイト(1)
MID_RELIANCE_B_#022	キャラモーション再生(PID_リュール, Surprise)\nキャラモーション再生(PID_リュール, Sad,, 1.3)\n\nキャラカメラ(CharaCam_Side_Left2_Top, PID_リュール, cam_anim_zoom_out_normal)\n\n*\n\nフェードアウト()
MID_RELIANCE_A_#001	キャラ配置(PID_リュール, ME_IN_C, [服装], Normal, IdleNormal, 0)\nキャラ配置(PID_アルフレッド, YOU_IN_C, [服装], Normal, IdleNormal, 0)\n\n背景(Map_Event_Hub_Solanel_09_Day)\nライト(CharaLight_Hub_Day, 0, 0, 0)\n\nキャラ視線(PID_リュール, PID_アルフレッド, PID_アルフレッド)\nキャラ視線(PID_アルフレッド, PID_リュール, PID_リュール)\n\nウェイト(1)\n\nキャラモーション再生(PID_リュール, Sad)\n\nキャラカメラ(CharaCam_Shoulder_Left_Top, PID_アルフレッド, cam_anim_track2_l_normal)\n\nフェードイン()
MID_RELIANCE_A_#002	
MID_RELIANCE_A_#003	キャラモーション再生(PID_アルフレッド, Sad, EmoSad2,, 0.3)\n\nキャラカメラ(CharaCam_Side_Right2_Mid, PID_アルフレッド, cam_anim_track_l_normal)
MID_RELIANCE_A_#004	キャラモーション再生(PID_リュール, Normal, EmoTalk)\nキャラモーション再生(PID_アルフレッド, Sad, IdleNormal)\n\nキャラカメラ(CharaCam_Front_Center_Top, PID_リュール, cam_anim_pan_u_slow)
MID_RELIANCE_A_#005	キャラモーション再生(PID_リュール, Relax)
MID_RELIANCE_A_#006	キャラモーション再生(PID_リュール, Sad, EmoRelax,, 1)\n\nキャラカメラ(CharaCam_FrontLong2_Left_Top, PID_リュール, cam_anim_track2_l_normal)
MID_RELIANCE_A_#007	キャラモーション再生(PID_リュール, Sad, IdleNormal)\n\nキャラカメラ(CharaCam_Side_Right2_Mid, PID_アルフレッド, cam_anim_track_l_slow)
MID_RELIANCE_A_#008	キャラモーション再生(PID_アルフレッド, Sad, EmoDeny2,, 0.3)
MID_RELIANCE_A_#009	キャラモーション再生(PID_リュール, Smile)\nキャラモーション再生(PID_アルフレッド, Sad, IdleNormal)\n\nキャラカメラ(CharaCam_Side_Left2_Top, PID_リュール, cam_anim_zoom_in_slow)
MID_RELIANCE_A_#010	
MID_RELIANCE_A_#011	キャラモーション再生(PID_リュール, Sad)
MID_RELIANCE_A_#012	キャラモーション再生(PID_アルフレッド, Normal)\nキャラモーション再生(PID_リュール, Sad, IdleNormal)\n\nキャラカメラ(CharaCam_Front_Center_Top, PID_アルフレッド, cam_anim_pan_u_normal)
MID_RELIANCE_A_#013	キャラモーション再生(PID_アルフレッド, Smile, EmoRelax,, 0.3)\n\nキャラカメラ(CharaCam_Shoulder_Right_Mid, PID_リュール, cam_anim_track2_r_normal)
MID_RELIANCE_A_#014	キャラモーション再生(PID_アルフレッド, Relax)
MID_RELIANCE_A_#015	
MID_RELIANCE_A_#016	キャラモーション再生(PID_アルフレッド, Relax, EmoTalk2, 3, 1)\n\nキャラカメラ(CharaCam_Side_Right2_Mid, PID_アルフレッド, cam_anim_track_l_normal)
MID_RELIANCE_A_#017	キャラモーション再生(PID_リュール, Smile)\nキャラモーション再生(PID_アルフレッド, Relax, IdleNormal)\n\nキャラカメラ(CharaCam_Side_Left2_Mid, PID_リュール, cam_anim_track_r_normal)
MID_RELIANCE_A_#018	キャラモーション再生(PID_アルフレッド, Smile)\n\nキャラカメラ(CharaCam_Front_Center_Mid, PID_アルフレッド, cam_anim_zoom_in_slow)
MID_RELIANCE_A_#019	キャラモーション再生(PID_アルフレッド, Smile, EmoJoy,, 0.3)
MID_RELIANCE_A_#020	キャラモーション再生(PID_リュール, Surprise)\nキャラモーション再生(PID_アルフレッド, Smile, IdleNormal)\n\nキャラ視線リセット(PID_リュール)\n\nキャラカメラ(CharaCam_Front_Center_Mid, PID_リュール, cam_anim_zoom_in_normal)
MID_RELIANCE_A_#021	キャラモーション再生(PID_アルフレッド, Smile, TurnL)\n\nキャラ回転(PID_アルフレッド, 280, 1.3)\n\nシーンカメラ(SceneCam_SideMe_Right_Mid, cam_anim_zoom_in_normal)\n\n*\n\nキャラモーション再生(PID_アルフレッド, Smile, RunOut,, 1)\n\nウェイト(1)
MID_RELIANCE_A_#022	キャラモーション再生(PID_リュール, Surprise, TurnR)\n\nキャラ回転(PID_リュール, 80, 1.3)\n\nキャラカメラ(CharaCam_Side_Left2_Mid, PID_リュール, cam_anim_track_r_slow)
MID_RELIANCE_A_#023	キャラモーション再生(PID_リュール, Surprise, RunOut,, 1)\n\n*\n\nフェードアウト()
MID_RELIANCE_S_#001	キャラ配置(PID_リュール, ME_IN_C, [服装], Normal, IdleNormal, 0)\nキャラ配置(PID_アルフレッド, YOU_IN_C, [服装], Normal, IdleNormal, 0)\n\n背景(Map_Event_Hub_Solanel_09_Day)\nライト(CharaLight_Hub_Day, 0, 0, 0)\n\nキャラ視線(PID_リュール, PID_アルフレッド, PID_アルフレッド)\nキャラ視線(PID_アルフレッド, PID_リュール, PID_リュール)\n\nウェイト(1)\n\nキャラモーション再生(PID_アルフレッド, Sad, WalkIn2)\n\nキャラカメラ(CharaCam_Shoulder_Right_Mid, PID_リュール, cam_anim_track2_r_normal)\n\nフェードイン()
MID_RELIANCE_S_#002	キャラモーション再生(PID_リュール, Smile)\nキャラモーション再生(PID_リュール, Normal,, 3)\nキャラモーション再生(PID_アルフレッド, Sad, IdleNormal)\n\nキャラカメラ(CharaCam_Side_Left2_Mid, PID_リュール, cam_anim_track_r_normal)
MID_RELIANCE_S_#003	キャラモーション再生(PID_アルフレッド, Sad, EmoThink)\n\nキャラカメラ(CharaCam_Side_Right2_Mid, PID_アルフレッド, cam_anim_track_l_slow)
MID_RELIANCE_S_#004	
MID_RELIANCE_S_#005	キャラモーション再生(PID_リュール, Relax, EmoNod)\nキャラモーション再生(PID_アルフレッド, Normal, IdleNormal)\n\nキャラカメラ(CharaCam_Side_Left2_Mid, PID_リュール, cam_anim_track_r_normal)
MID_RELIANCE_S_#006	キャラモーション再生(PID_アルフレッド, Sad, EmoSad)\nキャラモーション再生(PID_リュール, Relax, IdleNormal)\n\nキャラカメラ(CharaCam_Front_Center_Mid, PID_アルフレッド, cam_anim_pan_d_slow)
MID_RELIANCE_S_#007	
MID_RELIANCE_S_#008	キャラカメラ(CharaCam_Shoulder_Right_Mid, PID_リュール, cam_anim_track2_r_normal)
MID_RELIANCE_S_#009	キャラモーション再生(PID_リュール, Normal, EmoThink,, 0.3)\nキャラモーション再生(PID_アルフレッド, Sad, IdleNormal)\n\nキャラカメラ(CharaCam_Side_Left3_Mid, PID_リュール, cam_anim_pan_d_normal)
MID_RELIANCE_S_#010	キャラモーション再生(PID_アルフレッド, Sad)\nキャラモーション再生(PID_リュール, Normal, IdleNormal)\n\nキャラカメラ(CharaCam_Side_Right2_Mid, PID_アルフレッド, cam_anim_track_l_normal)
MID_RELIANCE_S_#011	キャラモーション再生(PID_リュール, Sad, EmoDeny)\n\nキャラカメラ(CharaCam_Side_Left2_Mid, PID_リュール, cam_anim_track_r_normal)
MID_RELIANCE_S_#012	キャラモーション再生(PID_アルフレッド, Die)\nキャラモーション再生(PID_リュール, Sad, IdleNormal)\n\nキャラカメラ(CharaCam_Side_Right2_Top, PID_アルフレッド, cam_anim_track_l_slow)
MID_RELIANCE_S_#013	
MID_RELIANCE_S_#014	キャラモーション再生(PID_アルフレッド, Normal)\n\nキャラカメラ(CharaCam_Front_Center_Top, PID_アルフレッド, cam_anim_zoom_out_slow)
MID_RELIANCE_S_#015	キャラモーション再生(PID_アルフレッド, Normal, EmoRelax,, 0.3)
MID_RELIANCE_S_#016	キャラモーション再生(PID_リュール, Surprise)\nキャラモーション再生(PID_アルフレッド, Normal, IdleNormal)\n\nキャラカメラ(CharaCam_Front_Center_Mid, PID_リュール, cam_anim_zoom_in_normal)
MID_RELIANCE_S_#017	キャラモーション再生(PID_アルフレッド, Die)\nキャラモーション再生(PID_アルフレッド, Normal,, 5)\n\nキャラカメラ(CharaCam_Side_Right2_Mid, PID_アルフレッド, cam_anim_track_l_slow)
MID_RELIANCE_S_#018	キャラモーション再生(PID_アルフレッド, Normal, EmoGive,, 0.3)
MID_RELIANCE_S_#019	キャラモーション再生(PID_リュール, Surprise, EmoTalk2)\nキャラモーション再生(PID_アルフレッド, Normal, IdleNormal)\n\nキャラカメラ(CharaCam_Side_Left_Mid, PID_リュール, cam_anim_track_r_normal)
MID_RELIANCE_S_#020	キャラモーション再生(PID_リュール, Surprise, IdleNormal,, 1)\n\nキャラカメラ(CharaCam_Shoulder_Right_Mid, PID_リュール, cam_anim_track2_r_normal)
MID_RELIANCE_S_#021	キャラカメラ(CharaCam_Front_Center_Top, PID_アルフレッド, cam_anim_pan_u_slow)
MID_RELIANCE_S_#022	キャラモーション再生(PID_アルフレッド, Normal, EmoRelax, 3, 0.3)
MID_RELIANCE_S_#023	キャラモーション再生(PID_リュール, Shy)\nキャラモーション再生(PID_アルフレッド, Normal)\n\nキャラカメラ(CharaCam_Shoulder_Left_Top, PID_アルフレッド, cam_anim_track2_l_normal)
MID_RELIANCE_S_#024	キャラモーション再生(PID_リュール, Smile, EmoRelax,, 0.3)\nキャラモーション再生(PID_アルフレッド, Normal, IdleNormal)\n\nキャラカメラ(CharaCam_Front_Center_Mid, PID_リュール, cam_anim_zoom_in_normal)
MID_RELIANCE_S_#025	キャラモーション再生(PID_アルフレッド, Smile)\nキャラモーション再生(PID_リュール, Smile, IdleNormal)\n\nキャラカメラ(CharaCam_Front_Center_Mid, PID_アルフレッド, cam_anim_zoom_in_normal)
MID_RELIANCE_S_#026	キャラカメラ(CharaCam_Side_Left2_Top, PID_リュール, cam_anim_zoom_in_slow)
MID_RELIANCE_S_#027	
MID_RELIANCE_S_#028	キャラモーション再生(PID_リュール, Smile, EmoGive,, 0.3)\n\nキャラカメラ(CharaCam_Front_Center_Mid, PID_リュール, cam_anim_zoom_out_normal)\n\n*\n\nパペット会話中断()\n\n一枚絵表示(Tex_Event_ItemPicture_14, picture_item_fade_in_normal)\n\nシーンカメラ(SceneCam_SideMe_Right_Mid, cam_anim_zoom_in_normal)\n\nウェイト(1)
MID_RELIANCE_S_#029	キャラモーション再生(PID_アルフレッド, Surprise)\n\n*\n\nパペット会話中断()\n\n一枚絵非表示(picture_item_fade_out_normal)\n\nウェイト(1)
MID_RELIANCE_S_#030	キャラモーション再生(PID_リュール, Smile, IdleNormal,, 1)\n\nキャラカメラ(CharaCam_Front_Center_Mid, PID_リュール, cam_anim_zoom_in_normal)
MID_RELIANCE_S_#031	キャラモーション再生(PID_アルフレッド, Smile)\n\nキャラカメラ(CharaCam_Front_Center_Mid, PID_アルフレッド, cam_anim_zoom_in_normal)\n\n*\n\nパペット会話中断()
MID_RELIANCE_S_#032	フェードアウト()\n一枚絵表示(Tex_Event_Reliance_S_04)\nウェイト(0.8)\n\nフェードイン()\nウェイト(1.2)\n\n*\n\nウェイト(1)\nフェードアウト()
