MID_RELIANCE_C_#001	キャラ配置(PID_リュール, ME_IN_C, [服装], Normal, IdleNormal, 0)\nキャラ配置(PID_ヴェイル, YOU_IN_C, [服装], Normal, IdleNormal, 0)\n\n背景(Map_Event_Hub_MyRoom_01_Day)\nライト(CharaLight_Hub_Day, 0, 0, 0)\n\nキャラ視線(PID_リュール, PID_ヴェイル, PID_ヴェイル)\nキャラ視線(PID_ヴェイル, PID_リュール, PID_リュール)\n\nウェイト(1)\n\nキャラモーション再生(PID_ヴェイル, Sad)\n\nキャラカメラ(CharaCam_Shoulder_Right_Top, PID_リュール, cam_anim_zoom_in_normal)\n\nフェードイン()
MID_RELIANCE_C_#002	キャラモーション再生(PID_リュール, Normal, EmoThink,, 0.3)\n\nキャラカメラ(CharaCam_Side_Left3_Mid, PID_リュール, cam_anim_pan_d_normal)
MID_RELIANCE_C_#003	キャラモーション再生(PID_ヴェイル, Sad, EmoSad2,, 0.3)\nキャラモーション再生(PID_リュール, Normal, IdleNormal)\n\nキャラカメラ(CharaCam_Side_Right2_Mid, PID_ヴェイル, cam_anim_track_l_normal)
MID_RELIANCE_C_#004	キャラモーション再生(PID_リュール, Smile, EmoNod)\nキャラモーション再生(PID_ヴェイル, Sad, IdleNormal)\n\nキャラカメラ(CharaCam_Side_Left2_Mid, PID_リュール, cam_anim_track_r_slow)
MID_RELIANCE_C_#005	
MID_RELIANCE_C_#006	キャラモーション再生(PID_ヴェイル, Shy)\nキャラモーション再生(PID_リュール, Smile, IdleNormal)\n\nキャラカメラ(CharaCam_Front_Center_Top, PID_ヴェイル, cam_anim_zoom_out_slow)
MID_RELIANCE_C_#007	キャラモーション再生(PID_ヴェイル, Sad)\nキャラモーション再生(PID_ヴェイル, Sad, EmoSad, 4.5, 0.3)
MID_RELIANCE_C_#008	キャラモーション再生(PID_ヴェイル, Die)\n\nキャラカメラ(CharaCam_FrontLong2_Right_Bot, PID_ヴェイル, cam_anim_pan_r_slow)
MID_RELIANCE_C_#009	キャラモーション再生(PID_ヴェイル, Sad)
MID_RELIANCE_C_#010	キャラモーション再生(PID_リュール, Die, EmoDeny2,, 0.3)\nキャラモーション再生(PID_ヴェイル, Sad, IdleNormal)\n\nキャラカメラ(CharaCam_Side_Left2_Mid, PID_リュール, cam_anim_track_r_slow)
MID_RELIANCE_C_#011	キャラモーション再生(PID_リュール, Normal)
MID_RELIANCE_C_#012	キャラモーション再生(PID_ヴェイル, Shy)\nキャラモーション再生(PID_リュール, Normal, IdleNormal)\n\nキャラカメラ(CharaCam_Side_Right2_Mid, PID_ヴェイル, cam_anim_track_l_slow)
MID_RELIANCE_C_#013	キャラモーション再生(PID_ヴェイル, Strike)
MID_RELIANCE_C_#014	キャラカメラ(CharaCam_Shoulder_Right_Top, PID_リュール, cam_anim_zoom_in_normal)
MID_RELIANCE_C_#015	キャラモーション再生(PID_リュール, Smile, EmoNod,, 0.3)\n\nキャラカメラ(CharaCam_Front_Center2_Mid, PID_リュール, cam_anim_pan_d_slow)
MID_RELIANCE_C_#015_F	キャラモーション再生(PID_リュール, Smile, EmoNod,, 0.3)\n\nキャラカメラ(CharaCam_Front_Center2_Mid, PID_リュール, cam_anim_pan_d_slow)
MID_RELIANCE_C_#016	
MID_RELIANCE_C_#017	キャラモーション再生(PID_リュール, Smile, EmoRelax,, 1)
MID_RELIANCE_C_#018	キャラモーション再生(PID_ヴェイル, Smile)\nキャラモーション再生(PID_リュール, Smile, IdleNormal)\n\nキャラカメラ(CharaCam_Front_Center_Top, PID_ヴェイル, cam_anim_pan_u_normal)\n\n*\n\nフェードアウト()
MID_RELIANCE_B_#001	キャラ配置(PID_リュール, ME_IN_C, [服装], Normal, IdleNormal, 0)\nキャラ配置(PID_ヴェイル, YOU_IN_C, [服装], Normal, IdleNormal, 0)\n\n背景(Map_Event_Hub_MyRoom_01_Day)\nライト(CharaLight_Hub_Day, 0, 0, 0)\n\nキャラ視線(PID_リュール, PID_ヴェイル, PID_ヴェイル)\nキャラ視線(PID_ヴェイル, PID_リュール, PID_リュール)\n\nウェイト(1)\n\nキャラカメラ(CharaCam_Shoulder_Right_Top, PID_リュール, cam_anim_zoom_in_normal)\n\nフェードイン()
MID_RELIANCE_B_#002	キャラモーション再生(PID_リュール, Sad, EmoDeny2,, 0.3)\n\nキャラカメラ(CharaCam_Front_Center_Top, PID_リュール, cam_anim_pan_u_normal)
MID_RELIANCE_B_#003	キャラモーション再生(PID_ヴェイル, Normal, EmoSad,, 0.3)\nキャラモーション再生(PID_リュール, Sad, IdleNormal)\n\nキャラカメラ(CharaCam_Side_Right3_Mid, PID_ヴェイル, cam_anim_pan_d_normal)
MID_RELIANCE_B_#003_F	キャラモーション再生(PID_ヴェイル, Normal, EmoSad,, 0.3)\nキャラモーション再生(PID_リュール, Sad, IdleNormal)\n\nキャラカメラ(CharaCam_Side_Right3_Mid, PID_ヴェイル, cam_anim_pan_d_normal)
MID_RELIANCE_B_#004	キャラモーション再生(PID_リュール, Normal)\nキャラモーション再生(PID_ヴェイル, Normal, IdleNormal)\n\nキャラカメラ(CharaCam_Side_Left2_Mid, PID_リュール, cam_anim_track_r_normal)
MID_RELIANCE_B_#005	キャラモーション再生(PID_ヴェイル, Normal, EmoNod,, 0.3)\n\nキャラカメラ(CharaCam_Side_Right2_Mid, PID_ヴェイル, cam_anim_track_l_slow)
MID_RELIANCE_B_#006	キャラモーション再生(PID_ヴェイル, Sad, EmoSad2,, 1)
MID_RELIANCE_B_#007	キャラモーション再生(PID_ヴェイル, Normal)\n\nキャラカメラ(CharaCam_Shoulder_Right_Top, PID_リュール, cam_anim_zoom_in_slow)
MID_RELIANCE_B_#007_F	キャラモーション再生(PID_ヴェイル, Normal)\n\nキャラカメラ(CharaCam_Shoulder_Right_Top, PID_リュール, cam_anim_zoom_in_slow)
MID_RELIANCE_B_#008	キャラモーション再生(PID_ヴェイル, Relax, EmoTalk, 3.2, 1)
MID_RELIANCE_B_#009	キャラモーション再生(PID_ヴェイル, Smile)\n\nキャラカメラ(CharaCam_Side_Right2_Top, PID_ヴェイル, cam_anim_zoom_in_normal)
MID_RELIANCE_B_#010	キャラモーション再生(PID_リュール, Die, EmoRelax)\nキャラモーション再生(PID_ヴェイル, Smile, IdleNormal)\n\nキャラカメラ(CharaCam_Side_Left3_Mid, PID_リュール, cam_anim_pan_d_normal)
MID_RELIANCE_B_#011	キャラモーション再生(PID_ヴェイル, Shy)\nキャラモーション再生(PID_リュール, Die, IdleNormal)\n\nキャラカメラ(CharaCam_Front_Center_Top, PID_ヴェイル, cam_anim_pan_u_slow)
MID_RELIANCE_B_#012	キャラモーション再生(PID_ヴェイル, Sad, EmoSad,, 0.3)
MID_RELIANCE_B_#013	キャラモーション再生(PID_ヴェイル, Die)\nキャラモーション再生(PID_ヴェイル, Relax, EmoJoy, 4.6, 1)\n\nキャラカメラ(CharaCam_Shoulder_Right_Top, PID_リュール, cam_anim_track2_r_normal)
MID_RELIANCE_B_#014	キャラモーション再生(PID_リュール, Shy)\nキャラモーション再生(PID_ヴェイル, Relax, IdleNormal)\n\nキャラカメラ(CharaCam_Side_Left3_Mid, PID_リュール, cam_anim_pan_d_normal)
MID_RELIANCE_B_#015	キャラモーション再生(PID_ヴェイル, Smile, EmoThink,, 0.3)\n\nキャラカメラ(CharaCam_Side_Right2_Mid, PID_ヴェイル, cam_anim_track_l_slow)
MID_RELIANCE_B_#016	
MID_RELIANCE_B_#017	キャラモーション再生(PID_リュール, Smile, EmoRelax)\nキャラモーション再生(PID_ヴェイル, Smile, IdleNormal)\n\nキャラカメラ(CharaCam_Side_Left2_Top, PID_リュール, cam_anim_zoom_in_slow)
MID_RELIANCE_B_#018	
MID_RELIANCE_B_#019	キャラモーション再生(PID_ヴェイル, Relax, EmoTalk,, 0.3)\nキャラモーション再生(PID_リュール, Smile, IdleNormal)\n\nキャラカメラ(CharaCam_Front_Center_Top, PID_ヴェイル, cam_anim_pan_u_normal)
MID_RELIANCE_B_#020	キャラモーション再生(PID_リュール, Smile, EmoNod)\nキャラモーション再生(PID_ヴェイル, Relax, IdleNormal)\n\nキャラカメラ(CharaCam_Front_Center_Mid, PID_リュール, cam_anim_pan_d_normal)\n\n*\n\nフェードアウト()
MID_RELIANCE_A_#001	キャラ配置(PID_リュール, ME_IN_C, [服装], Normal, IdleNormal, 0)\nキャラ配置(PID_ヴェイル, YOU_IN_C, [服装], Normal, IdleNormal, 0)\n\n背景(Map_Event_Hub_Solanel_05_Evening)\nライト(CharaLight_Hub_Evening, 0, 0, 0)\n\nキャラ視線(PID_リュール, PID_ヴェイル, PID_ヴェイル)\nキャラ視線(PID_ヴェイル, PID_リュール, PID_リュール)\n\nウェイト(1)\n\nキャラモーション再生(PID_ヴェイル, Smile, EmoThink)\n\nキャラカメラ(CharaCam_Shoulder_Right_Top, PID_リュール, cam_anim_zoom_in_slow)\n\nフェードイン()
MID_RELIANCE_A_#002	
MID_RELIANCE_A_#003	キャラモーション再生(PID_ヴェイル, Smile, IdleNormal)\n\nキャラカメラ(CharaCam_Side_Left2_Mid, PID_リュール, cam_anim_track_r_slow)
MID_RELIANCE_A_#004	キャラモーション再生(PID_リュール, Normal, EmoTalk,, 0.3)
MID_RELIANCE_A_#005	キャラモーション再生(PID_ヴェイル, Sad)\nキャラモーション再生(PID_リュール, Normal, IdleNormal)\n\nキャラカメラ(CharaCam_Side_Right2_Mid, PID_ヴェイル, cam_anim_track_l_normal)
MID_RELIANCE_A_#006	キャラカメラ(CharaCam_Front_Center_Top, PID_リュール, cam_anim_pan_u_normal)
MID_RELIANCE_A_#007	キャラモーション再生(PID_ヴェイル, Die)\n\nキャラカメラ(CharaCam_Side_Right3_Mid, PID_ヴェイル, cam_anim_pan_d_slow)
MID_RELIANCE_A_#008	キャラモーション再生(PID_ヴェイル, Sad)
MID_RELIANCE_A_#009	キャラモーション再生(PID_ヴェイル, Sad, EmoSad,, 0.3)
MID_RELIANCE_A_#010	キャラモーション再生(PID_ヴェイル, Die)\n\nキャラカメラ(CharaCam_FrontLong2_Right_Bot, PID_ヴェイル, cam_anim_pan_r_slow)
MID_RELIANCE_A_#011	キャラモーション再生(PID_ヴェイル, Sad)
MID_RELIANCE_A_#011_F	キャラモーション再生(PID_ヴェイル, Sad)
MID_RELIANCE_A_#012	キャラモーション再生(PID_リュール, Sad)\nキャラモーション再生(PID_ヴェイル, Sad, IdleNormal)\n\nキャラカメラ(CharaCam_Side_Left3_Mid, PID_リュール, cam_anim_pan_d_normal)
MID_RELIANCE_A_#013	キャラカメラ(CharaCam_Shoulder_Right_Top, PID_リュール, cam_anim_zoom_in_slow)
MID_RELIANCE_A_#014	キャラモーション再生(PID_ヴェイル, Die)
MID_RELIANCE_A_#015	キャラモーション再生(PID_ヴェイル, Strike, EmoDeny2,, 1)\n\nキャラカメラ(CharaCam_Side_Right3_Mid, PID_ヴェイル, cam_anim_pan_d_slow)
MID_RELIANCE_A_#016	
MID_RELIANCE_A_#017	キャラモーション再生(PID_リュール, Smile, EmoRelax)\nキャラモーション再生(PID_ヴェイル, Strike, IdleNormal)\n\nキャラカメラ(CharaCam_Front_Center2_Mid, PID_リュール, cam_anim_pan_d_slow)
MID_RELIANCE_A_#018	キャラモーション再生(PID_リュール, Normal)
MID_RELIANCE_A_#019	キャラモーション再生(PID_リュール, Normal, EmoTalk,, 1)\n\nキャラカメラ(CharaCam_Shoulder_Left_Mid, PID_ヴェイル, cam_anim_track2_l_normal)
MID_RELIANCE_A_#020	キャラモーション再生(PID_ヴェイル, Normal, EmoRelax,, 0.3)\nキャラモーション再生(PID_リュール, Normal, IdleNormal)\n\nキャラカメラ(CharaCam_Side_Right2_Mid, PID_ヴェイル, cam_anim_track_l_normal)
MID_RELIANCE_A_#020_F	キャラモーション再生(PID_ヴェイル, Normal, EmoRelax,, 0.3)\nキャラモーション再生(PID_リュール, Normal, IdleNormal)\n\nキャラカメラ(CharaCam_Side_Right2_Mid, PID_ヴェイル, cam_anim_track_l_normal)
MID_RELIANCE_A_#021	キャラモーション再生(PID_リュール, Normal, EmoJoy)\nキャラモーション再生(PID_ヴェイル, Normal, IdleNormal)\n\nキャラカメラ(CharaCam_Side_Left2_Mid, PID_リュール, cam_anim_track_r_normal)
MID_RELIANCE_A_#022	キャラモーション再生(PID_ヴェイル, Relax)\nキャラモーション再生(PID_リュール, Normal, IdleNormal)\n\nキャラカメラ(CharaCam_Front_Center_Top, PID_ヴェイル, cam_anim_pan_u_normal)\n\n*\n\nフェードアウト()
MID_RELIANCE_S_#001	キャラ配置(PID_リュール, ME_IN_C, [服装], Normal, IdleNormal, 0)\nキャラ配置(PID_ヴェイル, YOU_IN_C, [服装], Normal, IdleNormal, 0)\n\n背景(Map_Event_Hub_Solanel_16_Day)\nライト(CharaLight_Hub_Day, 0, 0, 0)\n\nキャラ視線(PID_リュール, PID_ヴェイル, PID_ヴェイル)\nキャラ視線(PID_ヴェイル, PID_リュール, PID_リュール)\n\nウェイト(1)\n\nキャラモーション再生(PID_ヴェイル, Smile, EmoTalk)\n\nキャラカメラ(CharaCam_Shoulder_Right_Top, PID_リュール, cam_anim_zoom_in_normal)\n\nフェードイン()
MID_RELIANCE_S_#001_F	キャラ配置(PID_リュール, ME_IN_C, [服装], Normal, IdleNormal, 0)\nキャラ配置(PID_ヴェイル, YOU_IN_C, [服装], Normal, IdleNormal, 0)\n\n背景(Map_Event_M001_01)\nライト(CharaLight_M001, 0, 0, 0)\n\nキャラ視線(PID_リュール, PID_ヴェイル, PID_ヴェイル)\nキャラ視線(PID_ヴェイル, PID_リュール, PID_リュール)\n\nキャラモーション再生(PID_ヴェイル, Smile, EmoTalk)\n\nキャラカメラ(CharaCam_Shoulder_Right_Top, PID_リュール, cam_anim_zoom_in_normal)\n\nフェードイン()
MID_RELIANCE_S_#002	キャラモーション再生(PID_ヴェイル, Smile, IdleNormal)\n\nキャラカメラ(CharaCam_Side_Left2_Mid, PID_リュール, cam_anim_track_r_normal)
MID_RELIANCE_S_#003	キャラモーション再生(PID_ヴェイル, Smile, EmoGive)\n\nキャラカメラ(CharaCam_Side_Right_Mid, PID_ヴェイル, cam_anim_track_l_normal)
MID_RELIANCE_S_#004	キャラモーション再生(PID_リュール, Smile, EmoTalk)\nキャラモーション再生(PID_ヴェイル, Smile, IdleNormal)\n\nキャラカメラ(CharaCam_Front_Center2_Mid, PID_リュール, cam_anim_pan_d_normal)
MID_RELIANCE_S_#005	キャラモーション再生(PID_ヴェイル, Smile, EmoNod,, 0.3)\nキャラモーション再生(PID_リュール, Smile, IdleNormal)\n\nキャラカメラ(CharaCam_Side_Right2_Top, PID_ヴェイル, cam_anim_zoom_in_slow)
MID_RELIANCE_S_#006	キャラモーション再生(PID_ヴェイル, Smile, EmoRelax, 2.3, 1)
MID_RELIANCE_S_#007	キャラモーション再生(PID_ヴェイル, Smile, IdleNormal)\n\nキャラカメラ(CharaCam_Side_Left2_Mid, PID_リュール, cam_anim_track_r_normal)
MID_RELIANCE_S_#008	キャラモーション再生(PID_ヴェイル, Normal)\n\nキャラカメラ(CharaCam_Shoulder_Right_Top, PID_リュール, cam_anim_zoom_in_normal)
MID_RELIANCE_S_#009	キャラモーション再生(PID_リュール, Smile, EmoGive,, 0.3)\n\n一枚絵表示(Tex_Event_ItemPicture_14, picture_item_fade_in_normal)\n\nキャラカメラ(CharaCam_Side_Left_Mid, PID_リュール, cam_anim_track_r_normal)\n\n*\n\nパペット会話中断()\n\nウェイト(1)\n\n一枚絵非表示(picture_item_fade_out_normal)\n\nウェイト(1)
MID_RELIANCE_S_#010	キャラモーション再生(PID_ヴェイル, Surprise)\nキャラモーション再生(PID_ヴェイル, Sad,, 2)\nキャラモーション再生(PID_リュール, Smile, IdleNormal)\n\nキャラカメラ(CharaCam_Front_Center_Top, PID_ヴェイル, cam_anim_pan_u_normal)
MID_RELIANCE_S_#011	キャラモーション再生(PID_リュール, Normal, EmoNod)\nキャラモーション再生(PID_ヴェイル, Sad)\n\nキャラカメラ(CharaCam_Front_Center_Mid, PID_リュール, cam_anim_zoom_in_normal)
MID_RELIANCE_S_#012	キャラモーション再生(PID_リュール, Smile, IdleNormal)\n\nキャラカメラ(CharaCam_Side_Right3_Mid, PID_ヴェイル, cam_anim_pan_d_normal)
MID_RELIANCE_S_#013	キャラモーション再生(PID_リュール, Normal, EmoTalk)\n\nキャラカメラ(CharaCam_Shoulder_Left_Bot, PID_ヴェイル, cam_anim_zoom_in_normal)
MID_RELIANCE_S_#014	キャラモーション再生(PID_ヴェイル, Sad, EmoDeny2,, 1)\nキャラモーション再生(PID_リュール, Normal, IdleNormal)\n\nキャラカメラ(CharaCam_Front_Center2_Mid, PID_ヴェイル, cam_anim_pan_d_slow)
MID_RELIANCE_S_#015	
MID_RELIANCE_S_#016	キャラモーション再生(PID_リュール, Normal, EmoDeny2)\nキャラモーション再生(PID_ヴェイル, Sad, IdleNormal)\n\nキャラカメラ(CharaCam_Front_Center_Top, PID_リュール, cam_anim_pan_u_slow)
MID_RELIANCE_S_#017	キャラモーション再生(PID_リュール, Normal, IdleNormal,, 1)
MID_RELIANCE_S_#018	キャラモーション再生(PID_リュール, Smile)
MID_RELIANCE_S_#019	キャラモーション再生(PID_ヴェイル, Die)\n\nキャラカメラ(CharaCam_Shoulder_Right_Top, PID_リュール, cam_anim_track2_r_normal)
MID_RELIANCE_S_#020	キャラモーション再生(PID_ヴェイル, Normal, EmoNod,, 0.3)
MID_RELIANCE_S_#021	キャラモーション再生(PID_ヴェイル, Relax, EmoPray,, 1)\n\nキャラカメラ(CharaCam_Side_Right3_Mid, PID_ヴェイル, cam_anim_pan_d_normal)
MID_RELIANCE_S_#022	キャラモーション再生(PID_リュール, Smile, EmoRelax)\nキャラモーション再生(PID_ヴェイル, Relax, IdleNormal)\n\nキャラカメラ(CharaCam_Side_Left2_Top, PID_リュール, cam_anim_zoom_in_slow)
MID_RELIANCE_S_#023	
MID_RELIANCE_S_#024	キャラモーション再生(PID_リュール, Smile, EmoDeny2,, 1)
MID_RELIANCE_S_#025	キャラモーション再生(PID_リュール, Smile, EmoThink,, 1)\n\nキャラカメラ(CharaCam_Shoulder_Left_Mid, PID_ヴェイル, cam_anim_track2_l_normal)
MID_RELIANCE_S_#026	キャラモーション再生(PID_ヴェイル, Relax, EmoSad,, 0.3)\nキャラモーション再生(PID_リュール, Smile, IdleNormal)\n\nキャラカメラ(CharaCam_Side_Right2_Mid, PID_ヴェイル, cam_anim_track_l_normal)
MID_RELIANCE_S_#027	キャラモーション再生(PID_リュール, Normal)\nキャラモーション再生(PID_ヴェイル, Relax, IdleNormal)\n\nキャラカメラ(CharaCam_Side_Left3_Mid, PID_リュール, cam_anim_pan_d_slow)
MID_RELIANCE_S_#028	キャラモーション再生(PID_リュール, Smile, EmoRelax,, 0.3)
MID_RELIANCE_S_#029	キャラモーション再生(PID_ヴェイル, Smile, EmoNod,, 0.3)\nキャラモーション再生(PID_リュール, Smile, IdleNormal)\n\nキャラカメラ(CharaCam_Front_Center_Top, PID_ヴェイル, cam_anim_pan_u_slow)
MID_RELIANCE_S_#030	
MID_RELIANCE_S_#031	キャラモーション再生(PID_リュール, Smile, EmoJoy)\n\nキャラカメラ(CharaCam_Front_Center2_Mid, PID_リュール, cam_anim_pan_d_normal)\n\n*\n\nパペット会話中断()
MID_RELIANCE_S_#032	フェードアウト()\n一枚絵表示(Tex_Event_Reliance_S_34)\nウェイト(0.8)\n\nフェードイン()\nウェイト(1.2)\n\n*\n\nウェイト(1)\nフェードアウト()
