MID_RELIANCE_C_#001	キャラ配置(PID_リュール, ME_IN_C,, Normal, IdleNormal)\nキャラ配置(PID_ディアマンド, YOU_IN_C,, Normal, EmoThinkLoop, -90)\n\n背景(Map_Event_M019_02)\nライト(CharaLight_M004, 0, 0, 0)\n\nキャラ表示切替(PID_リュール, False)\n\nシーンカメラ(SceneCam_SideYou_Right_Mid, cam_anim_track_l_normal)\nフェードイン()\n\nキャラモーション再生(PID_ディアマンド, Surprise, EmoThinkOut,,1)
MID_RELIANCE_C_#002	キャラモーション再生(PID_ディアマンド, , EmoLook,,1)\nキャラ視線(PID_ディアマンド, PID_リュール, PID_リュール, 4)\n*\nキャラ表示切替(PID_リュール, True)\nキャラ視線(PID_ディアマンド, PID_リュール, PID_リュール)\nキャラモーション再生(PID_ディアマンド, , IdleNormal,,0.5)
MID_RELIANCE_C_#003	キャラカメラ(CharaCam_Shoulder_Right_Mid, PID_ディアマンド, cam_anim_dolly_r_normal)\nキャラ回転(PID_ディアマンド, 90, 1)\nキャラモーション再生(PID_リュール, Pain, RunIn)\nキャラモーション再生(PID_リュール, Sad,,3)\n*\nフェードアウト()\nパペット会話中断()\nキャラモーション再生(PID_リュール, Normal, IdleNormal)\nキャラ配置調整(PID_リュール, 0, 0, -0.1)\nキャラ表示切替(PID_リュール, False)\n\nキャラ視線リセット(PID_ディアマンド)\nキャラアニメーター切替(PID_ディアマンド, Unit/Anim/UnitAnims/UAS_Swd2AM)\nキャラモーション再生(PID_ディアマンド, Strike, IdleNormal_None)\nキャラ武器装備(PID_ディアマンド, IID_鉄の剣)\nキャラ回転(PID_ディアマンド, -90)\n\nウェイト(0.1)
MID_RELIANCE_C_#004	キャラカメラ(CharaCam_LowFront_Right, PID_ディアマンド, cam_anim_zoom_in_fast)\nフェードイン()\nキャラモーション再生(PID_ディアマンド, , Attack_None,,0.5)\nキャラモーション再生(PID_ディアマンド, Strike, IdleNormal_None, 1, 2)\n*\nキャラ表示切替(PID_ディアマンド, False)
MID_RELIANCE_C_#005	キャラカメラ(CharaCam_Side_Left2_Mid, PID_リュール, cam_anim_track_r_normal)\nキャラ表示切替(PID_リュール, True)\nキャラモーション再生(PID_リュール, Sad, EmoRelax,,1)\n\nキャラ削除(PID_ディアマンド)\nキャラ配置(PID_ディアマンド, YOU_IN_C,, , IdleNormal)\nキャラ視線(PID_ディアマンド, PID_リュール, PID_リュール)\n*\nキャラモーション再生(PID_リュール, Sad, IdleNormal,,1)
MID_RELIANCE_C_#006	キャラカメラ(CharaCam_FrontLong2_Right_Mid, PID_ディアマンド, cam_anim_pan_l_slow)\n\nキャラ視線(PID_リュール, PID_ディアマンド, PID_ディアマンド)
MID_RELIANCE_C_#007	キャラモーション再生(PID_ディアマンド, , EmoTalk,,1)\n*\nキャラモーション再生(PID_ディアマンド, Normal, IdleNormal)
MID_RELIANCE_C_#008	キャラカメラ(CharaCam_Side_Left2_Top, PID_リュール, cam_anim_track_r_normal)\nキャラモーション再生(PID_リュール, , EmoSad,,1)\n*\nキャラモーション再生(PID_リュール, Normal, IdleNormal,,1)
MID_RELIANCE_C_#009	キャラカメラ(CharaCam_FrontLong2_Right_Mid, PID_ディアマンド, cam_anim_pan_r_normal)\nキャラモーション再生(PID_ディアマンド, , EmoThink,,1)\n*\nキャラモーション再生(PID_ディアマンド, Normal, IdleNormal)
MID_RELIANCE_C_#010	キャラカメラ(CharaCam_SideLong_Left2_Mid, PID_リュール, cam_anim_track3_r_normal)\nキャラモーション再生(PID_リュール, , EmoJoy, 2, 1)
MID_RELIANCE_C_#011	キャラモーション再生(PID_リュール, Sad, EmoDeny2,,1)
MID_RELIANCE_C_#012	キャラカメラ(CharaCam_Side_Left2_Mid, PID_リュール, cam_anim_track_r_normal)\n*\nキャラモーション再生(PID_リュール, Normal, IdleNormal,,1)
MID_RELIANCE_C_#013	キャラカメラ(CharaCam_FrontLong2_Right_Mid, PID_ディアマンド, cam_anim_pan_l_normal)\nキャラモーション再生(PID_ディアマンド, , EmoAngry,,1)\n*\nキャラモーション再生(PID_ディアマンド, Normal, IdleNormal,,1)
MID_RELIANCE_C_#014	キャラカメラ(CharaCam_FrontLong2_Left_Top, PID_リュール, cam_anim_pan_r_normal)\nキャラモーション再生(PID_リュール, , EmoTalk,,1)\n*\nキャラモーション再生(PID_リュール, Normal, IdleNormal)
MID_RELIANCE_C_#015	キャラカメラ(CharaCam_Side_Right3_Mid, PID_ディアマンド, cam_anim_dolly_r_normal)\nキャラモーション再生(PID_ディアマンド, , EmoThinkIn,,1)\n*\nキャラモーション再生(PID_ディアマンド, Serious)
MID_RELIANCE_C_#016	キャラカメラ(CharaCam_Side_Left2_Top, PID_リュール, cam_anim_track_r_normal)
MID_RELIANCE_C_#017	キャラモーション再生(PID_リュール, , EmoTalk,,1)\n*\nキャラモーション再生(PID_リュール, Normal, IdleNormal,,1)
MID_RELIANCE_C_#018	キャラカメラ(CharaCam_FrontLong2_Right_Mid, PID_ディアマンド, cam_anim_pan_r_normal)
MID_RELIANCE_C_#019	キャラカメラ(CharaCam_Side_Left3_Mid, PID_リュール, cam_anim_track_l_normal)\nキャラモーション再生(PID_リュール, , EmoTalk,,0.5)\n*\nキャラモーション再生(PID_リュール, Sad, IdleNormal)
MID_RELIANCE_C_#020	キャラカメラ(CharaCam_Side_Right2_Mid, PID_ディアマンド, cam_anim_track_l_normal)\nキャラモーション再生(PID_ディアマンド, Normal, EmoNod,,1)\n*\nキャラモーション再生(PID_ディアマンド, Relax, IdleNormal,,1)
MID_RELIANCE_C_#021	キャラカメラ(CharaCam_FrontLong2_Left_Top, PID_リュール, cam_anim_pan_l_normal)\nキャラモーション再生(PID_リュール, , EmoSad,,1)\n*\nキャラモーション再生(PID_リュール, Shy, IdleNormal)
MID_RELIANCE_C_#022	キャラカメラ(CharaCam_Side_Right3_Mid, PID_ディアマンド, cam_anim_track3_r_normal)\nキャラモーション再生(PID_ディアマンド, , EmoProud,,1)\n*\nキャラモーション再生(PID_ディアマンド, Normal, IdleNormal)
MID_RELIANCE_C_#023	キャラカメラ(CharaCam_SideLong_Left2_Mid, PID_リュール, cam_anim_pan_u_slow)\nキャラモーション再生(PID_リュール, , EmoShy,,1)
MID_RELIANCE_C_#024	キャラモーション再生(PID_リュール, Sad, EmoDeny2,,1)
MID_RELIANCE_C_#025	キャラカメラ(CharaCam_FrontLong2_Left_Top, PID_リュール, cam_anim_pan_r_slow)\nキャラモーション再生(PID_リュール, , EmoPray,,1)\n*\nキャラモーション再生(PID_リュール, Normal, IdleNormal)
MID_RELIANCE_C_#026	キャラカメラ(CharaCam_Front_Right_Bot, PID_ディアマンド, cam_anim_pan_u_slow)\nキャラモーション再生(PID_ディアマンド, , EmoThinkIn,,1)\n*\nフェードアウト()
MID_RELIANCE_B_#001	キャラ配置(PID_リュール, YOU_IN_C,, Normal, IdleNormal)\nキャラ配置調整(PID_リュール, 0, 0, 0.1)\nキャラ配置(PID_ディアマンド, ME_IN_C,, Normal, IdleNormal, -30)\n\n背景(Map_Event_Hub_Solanel_07_Day)\nライト(CharaLight_Hub_Day)\n\nキャラ視線(PID_リュール, PID_ディアマンド, PID_ディアマンド)\n\nキャラカメラ(CharaCam_SideLong_Right2_Mid, PID_ディアマンド, cam_anim_track_l_normal)\nフェードイン()\nキャラモーション再生(PID_ディアマンド, , IdleNormal,,1)\n*\nキャラモーション再生(PID_ディアマンド, Normal, IdleNormal,,1)
MID_RELIANCE_B_#002	キャラカメラ(CharaCam_FrontLong2_Left_Top, PID_リュール, cam_anim_pan_l_normal)\nキャラモーション再生(PID_リュール, , EmoTalk,,1)\n\nキャラ視線(PID_ディアマンド, PID_リュール, PID_リュール, 1)\n*\nキャラモーション再生(PID_リュール, Normal, IdleNormal,,1)
MID_RELIANCE_B_#003	キャラカメラ(CharaCam_FrontLong2_Right_Mid, PID_ディアマンド, cam_anim_pan_r_normal)\nキャラ回転(PID_ディアマンド, 30, 1)\nキャラモーション再生(PID_ディアマンド, , EmoSad,,1)\n*\nキャラモーション再生(PID_ディアマンド, Normal, IdleNormal)
MID_RELIANCE_B_#004	キャラカメラ(CharaCam_Side_Left3_Top, PID_リュール, cam_anim_track_l_normal)\nキャラモーション再生(PID_リュール, , EmoTalk,,1)\n*\nキャラモーション再生(PID_リュール, Normal, IdleNormal)
MID_RELIANCE_B_#005	キャラカメラ(CharaCam_Side_Right3_Mid, PID_ディアマンド, cam_anim_track_r_normal)\nキャラモーション再生(PID_ディアマンド, , EmoPray,,1)\n*\nキャラモーション再生(PID_ディアマンド, Normal, IdleNormal)
MID_RELIANCE_B_#006	キャラカメラ(CharaCam_Side_Left2_Mid, PID_リュール, cam_anim_track_r_normal)\n*\nキャラモーション再生(PID_リュール, Normal, IdleNormal)
MID_RELIANCE_B_#007	キャラカメラ(CharaCam_SideLong_Right2_Mid, PID_ディアマンド, cam_anim_pan_u_slow)\nキャラモーション再生(PID_ディアマンド, , EmoTalk,,1)
MID_RELIANCE_B_#008	\nキャラモーション再生(PID_ディアマンド, , EmoThinkIn,,1)
MID_RELIANCE_B_#009	キャラカメラ(CharaCam_Side_Right3_Mid, PID_ディアマンド, cam_anim_track3_r_normal)\nキャラモーション再生(PID_ディアマンド, Smile, EmoProud,,1)
MID_RELIANCE_B_#010	キャラモーション再生(PID_ディアマンド, Normal, IdleNormal,,1)
MID_RELIANCE_B_#011	キャラモーション再生(PID_ディアマンド, , EmoDeny2,,1)\n*\nキャラモーション再生(PID_ディアマンド, Normal, IdleNormal,,1)
MID_RELIANCE_B_#012	キャラカメラ(CharaCam_FrontLong2_Left_Top, PID_リュール, cam_anim_pan_l_normal)\nキャラモーション再生(PID_リュール, , EmoTalk,,1)\n*\nキャラモーション再生(PID_リュール, Relax, IdleNormal,,1)
MID_RELIANCE_B_#013	キャラカメラ(CharaCam_FrontLong2_Right_Mid, PID_ディアマンド, cam_anim_pan_r_normal)
MID_RELIANCE_B_#014	キャラモーション再生(PID_ディアマンド, , EmoTalk,,1)\n*\nキャラモーション再生(PID_ディアマンド, Normal, IdleNormal)
MID_RELIANCE_B_#015	キャラカメラ(CharaCam_SideLong_Left2_Mid, PID_リュール, cam_anim_pan_u_slow)\nキャラモーション再生(PID_リュール, , EmoRelax,,1)
MID_RELIANCE_B_#016	キャラモーション再生(PID_リュール, Normal, EmoTalk,,1)\n*\nキャラモーション再生(PID_リュール, Normal, IdleNormal)
MID_RELIANCE_B_#017	キャラカメラ(CharaCam_Side_Right_Mid, PID_ディアマンド, cam_anim_dolly_r_normal)\n*\nキャラモーション再生(PID_ディアマンド, Relax)
MID_RELIANCE_B_#018	キャラカメラ(CharaCam_FrontLong2_Left_Top, PID_リュール, cam_anim_pan_r_slow)\nキャラモーション再生(PID_リュール, , EmoTalk,,1)
MID_RELIANCE_B_#019	キャラモーション再生(PID_リュール, , EmoJoy,,1)\n*\nキャラモーション再生(PID_リュール, Normal, IdleNormal)
MID_RELIANCE_B_#020	キャラカメラ(CharaCam_Side_Right3_Mid, PID_ディアマンド, cam_anim_zoom_in_slow)\nキャラモーション再生(PID_ディアマンド, , EmoDeny2,,1)\n*\nフェードアウト()
MID_RELIANCE_A_#001	キャラ配置(PID_リュール, ME_IN_C,, Normal, IdleNormal, 80)\nキャラ配置調整(PID_リュール, 0, 0, -0.1)\nキャラ配置(PID_ディアマンド, YOU_IN_C,, Normal, IdleNormal, -10)\nキャラ表示切替(PID_ディアマンド, False)\n\n背景(Map_Event_Hub_Solanel_07_Day)\nライト(CharaLight_Hub_Day)\n\nキャラ視線(PID_ディアマンド, PID_リュール, PID_リュール)\n\nキャラカメラ(CharaCam_Side_Left3_Mid, PID_リュール, cam_anim_track3_r_normal)\nフェードイン()\nキャラモーション再生(PID_リュール, , IdleNormal,,1)\n*\nキャラモーション再生(PID_リュール, Normal, IdleNormal,,1)\nキャラ表示切替(PID_ディアマンド, True)
MID_RELIANCE_A_#002	キャラカメラ(CharaCam_FrontLong2_Right_Mid, PID_ディアマンド, cam_anim_pan_r_normal)\nキャラモーション再生(PID_ディアマンド, , WalkIn2)\n\nキャラ視線(PID_リュール, PID_ディアマンド, PID_ディアマンド, 1)\n*\nキャラモーション再生(PID_ディアマンド, Normal, IdleNormal)\nキャラ回転(PID_ディアマンド, 10, 1)
MID_RELIANCE_A_#003	キャラカメラ(CharaCam_SideLong_Left2_Mid, PID_リュール, cam_anim_pan_u_slow)\nキャラ視線リセット(PID_リュール)\nキャラ回転(PID_リュール, -80, 1)\nキャラモーション再生(PID_リュール, Serious, EmoSad,,1)\nキャラモーション再生(PID_リュール, Sad,,4)\n*\nキャラモーション再生(PID_リュール, Sad)
MID_RELIANCE_A_#004	キャラモーション再生(PID_リュール, , EmoDeny2,,1)\n*\nキャラモーション再生(PID_リュール, Normal, IdleNormal)\nキャラ視線(PID_リュール, PID_ディアマンド, PID_ディアマンド)
MID_RELIANCE_A_#005	キャラカメラ(CharaCam_Side_Right3_Mid, PID_ディアマンド, cam_anim_zoom_in_slow)\n*\nキャラモーション再生(PID_ディアマンド, Normal, IdleNormal,,1)
MID_RELIANCE_A_#006	キャラカメラ(CharaCam_FrontLong2_Left_Top, PID_リュール, cam_anim_pan_r_normal)\nキャラモーション再生(PID_リュール, , EmoTalk,,1)\n*\nキャラモーション再生(PID_リュール, Normal, IdleNormal,,1)
MID_RELIANCE_A_#007	キャラカメラ(CharaCam_FrontLong2_Right_Mid, PID_ディアマンド, cam_anim_pan_l_slow)\nキャラモーション再生(PID_ディアマンド, , EmoDeny,,1)\n*\nキャラモーション再生(PID_ディアマンド, Relax, IdleNormal)
MID_RELIANCE_A_#008	キャラカメラ(CharaCam_Side_Left2_Mid, PID_リュール, cam_anim_pan_r_normal)\nキャラモーション再生(PID_リュール, , EmoThinkIn,,1)\nキャラ視線リセット(PID_リュール)\n*\nキャラモーション再生(PID_リュール, , EmoThinkLoop)\nキャラ視線(PID_リュール, PID_ディアマンド, PID_ディアマンド)
MID_RELIANCE_A_#009	キャラカメラ(CharaCam_Side_Right3_Mid, PID_ディアマンド, cam_anim_zoom_in_slow)\n*\nキャラモーション再生(PID_ディアマンド, Relax, IdleNormal,,1)
MID_RELIANCE_A_#010	キャラカメラ(CharaCam_FrontLong2_Left_Top, PID_リュール, cam_anim_pan_l_normal)\nキャラモーション再生(PID_リュール, , EmoThinkOut,,1)\n*\nキャラモーション再生(PID_リュール, Surprise, IdleNormal,,1)
MID_RELIANCE_A_#011	キャラカメラ(CharaCam_FrontLong2_Right_Mid, PID_ディアマンド, cam_anim_pan_r_normal)\nキャラモーション再生(PID_ディアマンド, , EmoAngry,,1)\n*\nキャラモーション再生(PID_ディアマンド, Smile, IdleNormal)
MID_RELIANCE_A_#012	キャラカメラ(CharaCam_Side_Left2_Mid, PID_リュール, cam_anim_track_r_normal)\nキャラモーション再生(PID_リュール, , EmoDeny,,1)\nキャラモーション再生(PID_リュール, Normal,,2)\n*\nキャラモーション再生(PID_リュール, Shy)
MID_RELIANCE_A_#013	キャラモーション再生(PID_リュール, , EmoShy,,1)\n*\nキャラモーション再生(PID_リュール, Relax, IdleNormal)
MID_RELIANCE_A_#014	キャラカメラ(CharaCam_Side_Right2_Mid, PID_ディアマンド, cam_anim_track3_r_normal)\nキャラモーション再生(PID_ディアマンド, , EmoNod,,1)
MID_RELIANCE_A_#015	キャラモーション再生(PID_ディアマンド, Relax, EmoPray,,1)
MID_RELIANCE_A_#016	キャラカメラ(CharaCam_SideLong_Right2_Mid, PID_ディアマンド, cam_anim_pan_u_slow)\nキャラモーション再生(PID_ディアマンド, , EmoTalk,,1)
MID_RELIANCE_A_#017	*\nキャラモーション再生(PID_ディアマンド, Relax, IdleNormal,,1)
MID_RELIANCE_A_#018	キャラカメラ(CharaCam_FrontLong2_Left_Top, PID_リュール, cam_anim_track3_l_normal)\nキャラモーション再生(PID_リュール, , EmoRelax,,1)
MID_RELIANCE_A_#019	キャラモーション再生(PID_リュール, , EmoTalk,,1)\n*\nキャラモーション再生(PID_リュール, Relax, IdleNormal)
MID_RELIANCE_A_#020	キャラカメラ(CharaCam_Side_Right3_Mid, PID_ディアマンド, cam_anim_zoom_in_slow)\nキャラモーション再生(PID_ディアマンド, , EmoNod,,1)\n*\nキャラモーション再生(PID_ディアマンド, Normal, IdleNormal)
MID_RELIANCE_A_#021	キャラカメラ(CharaCam_Side_Left2_Mid, PID_リュール, cam_anim_track_r_normal)\nキャラモーション再生(PID_リュール, , EmoJoy, 4, 1)\n*\nフェードアウト()
MID_RELIANCE_S_#001	キャラ配置(PID_リュール, ME_IN_C,, Normal, IdleNormal, -100)\nキャラ配置(PID_ディアマンド, YOU_IN_C,, Normal, IdleNormal)\n\n背景(Map_Event_Hub_Solanel_05_Evening)\nライト(CharaLight_Hub_Evening)\n\nキャラ視線(PID_ディアマンド, PID_リュール, PID_リュール)\n\nシーンカメラ(SceneCam_SideMe_Left_Mid, cam_anim_zoom_in_normal)\nキャラモーション再生(PID_ディアマンド, , WalkIn2)\nフェードイン()\n\nキャラ視線(PID_リュール, PID_ディアマンド, PID_ディアマンド, 1)\n*\nキャラモーション再生(PID_ディアマンド, Normal, IdleNormal,,1)
MID_RELIANCE_S_#002	キャラカメラ(CharaCam_FrontLong2_Left_Top, PID_リュール, cam_anim_pan_l_normal)\nキャラ回転(PID_リュール, 100, 1)\nキャラモーション再生(PID_リュール, , TurnR,, 0.3)\n*\nキャラモーション再生(PID_リュール, Normal, IdleNormal)\nキャラ視線リセット(PID_リュール)
MID_RELIANCE_S_#003	キャラカメラ(CharaCam_SideLong_Right2_Mid, PID_ディアマンド, cam_anim_track3_l_normal)\nキャラモーション再生(PID_ディアマンド, , EmoGive,,1)\n*\nキャラモーション再生(PID_ディアマンド, Normal, IdleNormal)
MID_RELIANCE_S_#004	キャラカメラ(CharaCam_Side_Left2_Mid, PID_リュール, cam_anim_track_r_normal)\nキャラモーション再生(PID_リュール, , EmoThink,,1)\n*\nキャラモーション再生(PID_リュール, Surprise, IdleNormal)\nキャラ視線(PID_リュール, PID_ディアマンド, PID_ディアマンド)
MID_RELIANCE_S_#005	キャラカメラ(CharaCam_Side_Right3_Mid, PID_ディアマンド, cam_anim_zoom_in_slow)\nキャラモーション再生(PID_ディアマンド, , EmoNod,,1)\n*\nキャラモーション再生(PID_ディアマンド, Relax, IdleNormal,,1)
MID_RELIANCE_S_#006	キャラカメラ(CharaCam_FrontLong2_Left_Top, PID_リュール, cam_anim_pan_l_normal)\nキャラモーション再生(PID_リュール, , EmoSurprise,,1)\n*\nキャラモーション再生(PID_リュール, Sad, IdleNormal,,1)
MID_RELIANCE_S_#007	キャラカメラ(CharaCam_FrontLong2_Right_Mid, PID_ディアマンド, cam_anim_pan_r_normal)\nキャラモーション再生(PID_ディアマンド, , EmoDeny,,1)\n*\nキャラモーション再生(PID_ディアマンド, Relax, IdleNormal)
MID_RELIANCE_S_#008	キャラカメラ(CharaCam_Side_Left3_Mid, PID_リュール, cam_anim_zoom_in_slow)\n*\nキャラモーション再生(PID_リュール, Normal, IdleNormal,,1)
MID_RELIANCE_S_#009	キャラカメラ(CharaCam_FrontLong2_Right_Mid, PID_ディアマンド, cam_anim_track3_l_normal)\nキャラモーション再生(PID_ディアマンド, , EmoTalk,,1)
MID_RELIANCE_S_#010	キャラモーション再生(PID_ディアマンド, Smile)\n*\nキャラモーション再生(PID_ディアマンド, Normal, IdleNormal)
MID_RELIANCE_S_#011	キャラカメラ(CharaCam_Side_Left_Mid, PID_リュール, cam_anim_dolly_l_normal)
MID_RELIANCE_S_#012	キャラカメラ(CharaCam_Front_Center_Mid, PID_ディアマンド, cam_anim_zoom_out_normal)\nキャラモーション再生(PID_ディアマンド, , EmoRelax,,1)\n*\nキャラ表示切替(PID_ディアマンド, False)\nキャラモーション再生(PID_ディアマンド, Relax, IdleNormal)
MID_RELIANCE_S_#013	キャラカメラ(CharaCam_SideLong_Left2_Mid, PID_リュール, cam_anim_pan_u_slow)
MID_RELIANCE_S_#014	キャラモーション再生(PID_リュール, Serious, EmoSad,,1)\nキャラモーション再生(PID_リュール, Normal,,4)\n*\nキャラ表示切替(PID_ディアマンド, True)
MID_RELIANCE_S_#015	キャラカメラ(CharaCam_Side_Left3_Mid, PID_リュール, cam_anim_zoom_in_slow)\nキャラモーション再生(PID_リュール, Normal, EmoJoy,,1)\n*\nキャラモーション再生(PID_リュール, Smile, IdleNormal,,1)
MID_RELIANCE_S_#016	キャラカメラ(CharaCam_FrontLong2_Right_Mid, PID_ディアマンド, cam_anim_pan_l_slow)\nキャラモーション再生(PID_ディアマンド, , EmoTalk,,1)\n*\nキャラモーション再生(PID_ディアマンド, Smile, IdleNormal)
MID_RELIANCE_S_#017	キャラカメラ(CharaCam_Side_Left2_Mid, PID_リュール, cam_anim_track_r_normal)\nキャラモーション再生(PID_リュール, , EmoNod,,1)\nキャラモーション再生(PID_リュール, , IdleNormal, 1.5, 1)\n*\nキャラモーション再生(PID_リュール, Relax, IdleNormal)
MID_RELIANCE_S_#018	キャラカメラ(CharaCam_Side_Right2_Mid, PID_ディアマンド, cam_anim_track_l_normal)\nキャラモーション再生(PID_ディアマンド, , EmoRelax,,1)\n*\nキャラモーション再生(PID_ディアマンド, Surprise, IdleNormal)
MID_RELIANCE_S_#019	ライト(CharaLight_Hub_Evening, 0, -20, 0)\nキャラカメラ(CharaCam_SideLong_Left_Mid, PID_リュール, cam_anim_track_l_normal)\nキャラモーション再生(PID_リュール, , EmoGive,,1)\n一枚絵表示(Tex_Event_ItemPicture_14, picture_item_fade_in_normal)\n*\nキャラモーション再生(PID_リュール, Shy, IdleNormal)
MID_RELIANCE_S_#020	ライト(CharaLight_Hub_Evening, 0, 0, 0)\nキャラカメラ(CharaCam_SideLong_Right_Mid, PID_ディアマンド, cam_anim_track_r_normal)\nキャラモーション再生(PID_ディアマンド, , EmoThink,,1)\n*\nキャラモーション再生(PID_ディアマンド, Surprise, IdleNormal,,1)
MID_RELIANCE_S_#021	キャラカメラ(CharaCam_FrontLong2_Left_Top, PID_リュール, cam_anim_track_l_normal)\nキャラモーション再生(PID_リュール, , EmoShy,,1)\n*\nキャラモーション再生(PID_リュール, Smile, IdleNormal)\n一枚絵非表示(picture_item_fade_out_normal)\nキャラ視線リセット(PID_リュール)
MID_RELIANCE_S_#022	キャラカメラ(CharaCam_Side_Right2_Mid, PID_ディアマンド, cam_anim_track_l_normal)\nキャラモーション再生(PID_ディアマンド, , EmoDeny2,,1)\n*\nキャラ表示切替(PID_ディアマンド, False)\nキャラモーション再生(PID_ディアマンド, Smile, IdleNormal)
MID_RELIANCE_S_#023	キャラカメラ(CharaCam_SideLong_Left2_Mid, PID_リュール, cam_anim_track3_l_normal)\nキャラモーション再生(PID_リュール, , EmoPray,,1)\n*\nキャラ視線(PID_リュール, PID_ディアマンド, PID_ディアマンド)
MID_RELIANCE_S_#024	キャラモーション再生(PID_リュール, , EmoTalk,,1)\n*\nキャラモーション再生(PID_リュール, , IdleNormal)\nキャラ表示切替(PID_ディアマンド, True)\nキャラ視線リセット(PID_リュール)
MID_RELIANCE_S_#025	キャラカメラ(CharaCam_Side_Right3_Mid, PID_ディアマンド, cam_anim_track3_r_normal)\nキャラモーション再生(PID_ディアマンド, , EmoProud,,1)
MID_RELIANCE_S_#026	キャラモーション再生(PID_ディアマンド, , EmoPray,,1)\n*\nキャラモーション再生(PID_ディアマンド, , IdleNormal)
MID_RELIANCE_S_#027	キャラカメラ(CharaCam_Side_Left3_Top, PID_リュール, cam_anim_zoom_in_slow)\nキャラモーション再生(PID_リュール, , EmoPray,,1)\n*\nキャラモーション再生(PID_リュール, , IdleNormal,,1)\nキャラ視線(PID_リュール, PID_ディアマンド, PID_ディアマンド)
MID_RELIANCE_S_#028	キャラカメラ(CharaCam_FrontLong2_Right_Mid, PID_ディアマンド, cam_anim_track3_l_normal)\nキャラモーション再生(PID_ディアマンド, , EmoTalk,,1)\n*\nキャラモーション再生(PID_ディアマンド, , IdleNormal,,1)
MID_RELIANCE_S_#029	キャラカメラ(CharaCam_FrontLong2_Left_Top, PID_リュール, cam_anim_track3_r_normal)\nキャラモーション再生(PID_リュール, , EmoJoy,,1)\n*\nキャラモーション再生(PID_リュール, , IdleNormal,,1)
MID_RELIANCE_S_#030	キャラカメラ(CharaCam_Side_Right3_Mid, PID_ディアマンド, cam_anim_zoom_in_slow)\nキャラモーション再生(PID_ディアマンド, , EmoJoy,,1)\n\n*\n\nパペット会話中断()
MID_RELIANCE_S_#031	フェードアウト()\n一枚絵表示(Tex_Event_Reliance_S_10)\nウェイト(0.8)\n\nフェードイン()\nウェイト(1.2)\n\n*\n\nウェイト(1)\nフェードアウト()
