MID_RELIANCE_C_#001	キャラ配置(PID_リュール, ME_IN_C, [服装], Normal, IdleNormal, 0)\nキャラ配置(PID_モーヴ, YOU_IN_C, [服装], Normal, IdleNormal, 0)\n\n背景(Map_Event_Hub_Solanel_03_Day)\nライト(CharaLight_Hub_Day, 0, 0, 0)\n\nキャラ視線(PID_リュール, PID_モーヴ, PID_モーヴ)\nキャラ視線(PID_モーヴ, PID_リュール, PID_リュール)\n\nウェイト(1)\n\nキャラモーション再生(PID_リュール, Smile, EmoTalk)\n\nキャラカメラ(CharaCam_Shoulder_Left_Top, PID_モーヴ, cam_anim_track2_l_normal)\n\nフェードイン()
MID_RELIANCE_C_#002	キャラモーション再生(PID_リュール, Smile, IdleNormal)\n\nキャラカメラ(CharaCam_Side_Right2_Mid, PID_モーヴ, cam_anim_track_l_normal)
MID_RELIANCE_C_#003	キャラカメラ(CharaCam_Side_Left2_Mid, PID_リュール, cam_anim_track_r_normal)
MID_RELIANCE_C_#004	キャラカメラ(CharaCam_Front_Center2_Mid, PID_モーヴ, cam_anim_pan_d_slow)
MID_RELIANCE_C_#005	キャラモーション再生(PID_モーヴ, Normal, EmoDeny2,, 0.3)
MID_RELIANCE_C_#006	キャラモーション再生(PID_モーヴ, Normal, IdleNormal,, 1)\n\nキャラカメラ(CharaCam_Shoulder_Left_Top, PID_モーヴ, cam_anim_track2_l_normal)
MID_RELIANCE_C_#007	キャラモーション再生(PID_リュール, Smile, EmoNod,, 0.3)
MID_RELIANCE_C_#008	キャラモーション再生(PID_リュール, Smile, EmoRelax,, 1)\n\nキャラカメラ(CharaCam_Side_Left2_Top, PID_リュール, cam_anim_zoom_in_normal)
MID_RELIANCE_C_#009	キャラモーション再生(PID_リュール, Smile, IdleNormal)\n\nキャラカメラ(CharaCam_Side_Right3_Mid, PID_モーヴ, cam_anim_pan_d_normal)
MID_RELIANCE_C_#010	キャラモーション再生(PID_リュール, Smile, EmoTalk)\n\nキャラカメラ(CharaCam_Front_Center_Top, PID_リュール, cam_anim_zoom_out_normal)
MID_RELIANCE_C_#011	キャラモーション再生(PID_モーヴ, Normal)\n\nキャラカメラ(CharaCam_Shoulder_Right_Bot, PID_リュール, cam_anim_track2_r_normal)
MID_RELIANCE_C_#012	キャラモーション再生(PID_モーヴ, Normal, EmoRelax,, 0.3)\nキャラモーション再生(PID_リュール, Smile, IdleNormal,, 1)
MID_RELIANCE_C_#013	キャラモーション再生(PID_リュール, Sad)\nキャラモーション再生(PID_モーヴ, Normal, IdleNormal)\n\nキャラ視線リセット(PID_モーヴ)\n\nキャラカメラ(CharaCam_Side_Left2_Mid, PID_リュール, cam_anim_track_r_normal)
MID_RELIANCE_C_#014	キャラモーション再生(PID_モーヴ, Die)\n\nキャラカメラ(CharaCam_Side_Right2_Mid, PID_モーヴ, cam_anim_track_l_slow)
MID_RELIANCE_C_#015	キャラモーション再生(PID_モーヴ, Die, EmoDeny2,, 0.3)
MID_RELIANCE_C_#016	キャラモーション再生(PID_モーヴ, Normal, TurnL,, 0.7)\n\nキャラ回転(PID_モーヴ, 200, 1.5)\n\nキャラカメラ(CharaCam_Shoulder_Left_Top, PID_モーヴ, cam_anim_zoom_out_slow)\n\n*\n\nキャラモーション再生(PID_モーヴ, Normal, WalkOut,, 1)
MID_RELIANCE_C_#017	\n*\n\nフェードアウト()
MID_RELIANCE_B_#001	キャラ配置(PID_リュール, ME_IN_C, [服装], Normal, IdleNormal, 0)\nキャラ配置(PID_モーヴ, YOU_IN_C, [服装], Normal, IdleNormal, 0)\n\n背景(Map_Event_Hub_Solanel_17_Day)\nライト(CharaLight_Hub_Day, 0, 0, 0)\n\nキャラ視線(PID_リュール, PID_モーヴ, PID_モーヴ)\nキャラ視線(PID_モーヴ, PID_リュール, PID_リュール)\n\nウェイト(1)\n\nキャラカメラ(CharaCam_Shoulder_Left_Top, PID_モーヴ, cam_anim_zoom_in_slow)\n\nフェードイン()
MID_RELIANCE_B_#002	
MID_RELIANCE_B_#003	キャラモーション再生(PID_モーヴ, Die, EmoDeny2)\n\nキャラカメラ(CharaCam_Front_Center_Top, PID_モーヴ, cam_anim_pan_u_normal)
MID_RELIANCE_B_#004	キャラモーション再生(PID_モーヴ, Sad)\n\nキャラカメラ(CharaCam_Shoulder_Right_Bot, PID_リュール, cam_anim_track2_r_normal)
MID_RELIANCE_B_#005	キャラモーション再生(PID_モーヴ, Sad, EmoTalk2,, 1)
MID_RELIANCE_B_#006	キャラモーション再生(PID_リュール, Sad)\nキャラモーション再生(PID_モーヴ, Sad, IdleNormal)\n\nキャラカメラ(CharaCam_Front_Center_Top, PID_リュール, cam_anim_pan_u_normal)
MID_RELIANCE_B_#007	キャラカメラ(CharaCam_Side_Right3_Mid, PID_モーヴ, cam_anim_pan_d_slow)
MID_RELIANCE_B_#008	キャラモーション再生(PID_モーヴ, Die, EmoSad,, 0.3)
MID_RELIANCE_B_#009	キャラモーション再生(PID_モーヴ, Normal)\n\nキャラカメラ(CharaCam_Shoulder_Right_Bot, PID_リュール, cam_anim_zoom_in_slow)
MID_RELIANCE_B_#010	キャラモーション再生(PID_モーヴ, Normal, EmoTalk,, 1)
MID_RELIANCE_B_#011	キャラモーション再生(PID_モーヴ, Normal, IdleNormal)\n\nキャラカメラ(CharaCam_Side_Left2_Mid, PID_リュール, cam_anim_track_r_normal)
MID_RELIANCE_B_#012	キャラモーション再生(PID_モーヴ, Die)\n\nキャラカメラ(CharaCam_Side_Right2_Mid, PID_モーヴ, cam_anim_track_l_normal)
MID_RELIANCE_B_#013	キャラモーション再生(PID_リュール, Sad, EmoTalk)\n\nキャラカメラ(CharaCam_Front_Center2_Mid, PID_リュール, cam_anim_pan_d_normal)
MID_RELIANCE_B_#014	キャラモーション再生(PID_モーヴ, Normal, EmoDeny2)\nキャラモーション再生(PID_リュール, Sad, IdleNormal,, 1)\n\nキャラカメラ(CharaCam_Shoulder_Right_Bot, PID_リュール, cam_anim_zoom_in_slow)
MID_RELIANCE_B_#015	
MID_RELIANCE_B_#016	キャラモーション再生(PID_モーヴ, Die)\n\nキャラカメラ(CharaCam_Front_Center_Top, PID_モーヴ, cam_anim_pan_u_normal)\n\n*\n\nフェードアウト()
MID_RELIANCE_A_#001	キャラ配置(PID_リュール, ME_IN_C, [服装], Normal, IdleNormal, 0)\nキャラ配置(PID_モーヴ, YOU_IN_C, [服装], Normal, IdleNormal, 0)\n\n背景(Map_Event_Hub_Solanel_03_Day)\nライト(CharaLight_Hub_Day, 0, 0, 0)\n\nキャラ視線(PID_リュール, PID_モーヴ, PID_モーヴ)\nキャラ視線(PID_モーヴ, PID_リュール, PID_リュール)\n\nウェイト(1)\n\nキャラモーション再生(PID_リュール, Smile, EmoTalk)\n\nキャラカメラ(CharaCam_Shoulder_Left_Top, PID_モーヴ, cam_anim_track2_l_normal)\n\nフェードイン()
MID_RELIANCE_A_#002	キャラモーション再生(PID_リュール, Smile, IdleNormal)\n\nキャラカメラ(CharaCam_Side_Right2_Mid, PID_モーヴ, cam_anim_track_l_slow)
MID_RELIANCE_A_#003	キャラモーション再生(PID_モーヴ, Normal, EmoDeny2,, 0.3)
MID_RELIANCE_A_#004	キャラモーション再生(PID_モーヴ, Normal, IdleNormal)\n\nキャラカメラ(CharaCam_Side_Left2_Mid, PID_リュール, cam_anim_track_r_normal)
MID_RELIANCE_A_#005	キャラモーション再生(PID_モーヴ, Sad)\nキャラモーション再生(PID_リュール, Smile, IdleNormal)\n\nキャラカメラ(CharaCam_Front_Center_Top, PID_モーヴ, cam_anim_zoom_out_slow)
MID_RELIANCE_A_#006	キャラモーション再生(PID_モーヴ, Sad, EmoTalk,, 0.3)
MID_RELIANCE_A_#007	キャラモーション再生(PID_モーヴ, Sad, IdleNormal)\n\nキャラカメラ(CharaCam_Front_Center_Top, PID_リュール, cam_anim_pan_u_normal)
MID_RELIANCE_A_#008	キャラモーション再生(PID_モーヴ, Surprise, EmoDeny)\n\nキャラカメラ(CharaCam_Shoulder_Right_Bot, PID_リュール, cam_anim_zoom_in_normal)
MID_RELIANCE_A_#009	キャラモーション再生(PID_リュール, Smile, EmoNod,, 0.3)\nキャラモーション再生(PID_モーヴ, Surprise, IdleNormal)\n\nキャラカメラ(CharaCam_Side_Left2_Mid, PID_リュール, cam_anim_track_r_slow)
MID_RELIANCE_A_#010	キャラモーション再生(PID_リュール, Smile, EmoTalk,, 1)
MID_RELIANCE_A_#011	キャラモーション再生(PID_モーヴ, Sad)\nキャラモーション再生(PID_リュール, Smile, IdleNormal)\n\nキャラカメラ(CharaCam_Front_Center2_Mid, PID_モーヴ, cam_anim_pan_d_normal)
MID_RELIANCE_A_#012	キャラモーション再生(PID_リュール, Normal)\n\nキャラカメラ(CharaCam_Shoulder_Left_Top, PID_モーヴ, cam_anim_zoom_in_slow)
MID_RELIANCE_A_#013	
MID_RELIANCE_A_#014	キャラカメラ(CharaCam_Front_Center_Top, PID_リュール, cam_anim_pan_u_slow)
MID_RELIANCE_A_#015	
MID_RELIANCE_A_#016	キャラモーション再生(PID_リュール, Normal, IdleNormal)\n\nキャラカメラ(CharaCam_Side_Right2_Mid, PID_モーヴ, cam_anim_track_l_normal)
MID_RELIANCE_A_#017	キャラモーション再生(PID_リュール, Normal, EmoRelax)\n\nキャラカメラ(CharaCam_Side_Left2_Mid, PID_リュール, cam_anim_track_r_normal)
MID_RELIANCE_A_#018	キャラモーション再生(PID_モーヴ, Normal, EmoDeny2)\nキャラモーション再生(PID_リュール, Normal, IdleNormal)\n\nキャラカメラ(CharaCam_Side_Right3_Mid, PID_モーヴ, cam_anim_pan_d_slow)
MID_RELIANCE_A_#019	キャラモーション再生(PID_モーヴ, Normal, IdleNormal,, 1)
MID_RELIANCE_A_#020	キャラモーション再生(PID_モーヴ, Smile)\n\nキャラカメラ(CharaCam_Shoulder_Right_Bot, PID_リュール, cam_anim_zoom_in_normal)
MID_RELIANCE_A_#021	キャラモーション再生(PID_リュール, Smile)\n\nキャラカメラ(CharaCam_Front_Center_Top, PID_リュール, cam_anim_pan_u_normal)
MID_RELIANCE_A_#022	キャラモーション再生(PID_モーヴ, Smile, EmoTalk)\n\nキャラカメラ(CharaCam_Side_Right2_Mid, PID_モーヴ, cam_anim_track_l_normal)
MID_RELIANCE_A_#023	キャラモーション再生(PID_リュール, Smile, EmoJoy)\nキャラモーション再生(PID_モーヴ, Smile, IdleNormal)\n\nキャラカメラ(CharaCam_Side_Left2_Mid, PID_リュール, cam_anim_track_r_normal)
MID_RELIANCE_A_#024	キャラモーション再生(PID_モーヴ, Shy, EmoRelax)\nキャラモーション再生(PID_リュール, Smile, IdleNormal)\n\nキャラカメラ(CharaCam_Side_Right2_Top, PID_モーヴ, cam_anim_zoom_in_normal)
MID_RELIANCE_A_#025	キャラモーション再生(PID_リュール, Smile, EmoTalk2)\nキャラモーション再生(PID_モーヴ, Shy, IdleNormal)\n\nキャラカメラ(CharaCam_Front_Center2_Mid, PID_リュール, cam_anim_pan_d_normal)
MID_RELIANCE_A_#026	キャラモーション再生(PID_モーヴ, Smile)\nキャラモーション再生(PID_リュール, Smile, IdleNormal)\n\nキャラカメラ(CharaCam_Side_Right3_Mid, PID_モーヴ, cam_anim_pan_d_slow)
MID_RELIANCE_A_#027	キャラモーション再生(PID_モーヴ, Smile, EmoPray,, 1)\n\n*\n\nフェードアウト()
MID_RELIANCE_S_#001	キャラ配置(PID_リュール, ME_IN_C, [服装], Normal, IdleNormal, 0)\nキャラ配置(PID_モーヴ, YOU_IN_C, [服装], Normal, IdleNormal, 0)\nキャラ配置(PID_デモ用_視線設定用, YOU_MID_C, [服装], Normal, IdleNormal, 0)\n\nキャラ配置調整(PID_デモ用_視線設定用, 0, -1, 0, 0)\n\n背景(Map_Event_M019_02)\nライト(CharaLight_Hub_Day, 0, 0, 0)\n\nキャラ視線(PID_リュール, PID_モーヴ, PID_モーヴ)\nキャラ視線(PID_モーヴ, PID_リュール, PID_リュール)\n\nウェイト(1)\n\nキャラモーション再生(PID_モーヴ, Smile, EmoRelax)\n\nキャラカメラ(CharaCam_Shoulder_Right_Bot, PID_リュール, cam_anim_zoom_in_normal)\n\nフェードイン()
MID_RELIANCE_S_#002	キャラモーション再生(PID_リュール, Smile, EmoThink,, 0.3)\nキャラモーション再生(PID_モーヴ, Smile, IdleNormal)\n\nキャラカメラ(CharaCam_Side_Left2_Mid, PID_リュール, cam_anim_track_r_normal)
MID_RELIANCE_S_#003	キャラモーション再生(PID_リュール, Smile, IdleNormal)\n\nキャラカメラ(CharaCam_Side_Right2_Mid, PID_モーヴ, cam_anim_track_l_slow)
MID_RELIANCE_S_#004	キャラモーション再生(PID_モーヴ, Sad, EmoShy,, 0.3)
MID_RELIANCE_S_#005	キャラモーション再生(PID_リュール, Smile, EmoTalk)\nキャラモーション再生(PID_モーヴ, Sad, IdleNormal)\n\nキャラカメラ(CharaCam_Front_Center2_Mid, PID_リュール, cam_anim_pan_d_slow)
MID_RELIANCE_S_#006	
MID_RELIANCE_S_#007	キャラモーション再生(PID_モーヴ, Smile)\nキャラモーション再生(PID_リュール, Smile, IdleNormal)\n\nキャラカメラ(CharaCam_Side_Right3_Mid, PID_モーヴ, cam_anim_pan_d_slow)
MID_RELIANCE_S_#008	キャラモーション再生(PID_モーヴ, Smile, EmoRelax,, 0.3)
MID_RELIANCE_S_#009	キャラモーション再生(PID_モーヴ, Smile, IdleNormal)\n\nキャラカメラ(CharaCam_Front_Center_Top, PID_リュール, cam_anim_zoom_out_normal)
MID_RELIANCE_S_#010	キャラモーション再生(PID_モーヴ, Relax)\n\nキャラカメラ(CharaCam_Front_Center_Mid, PID_モーヴ, cam_anim_zoom_in_normal)
MID_RELIANCE_S_#011	キャラモーション再生(PID_リュール, Smile, EmoShy)\n\nキャラ視線(PID_リュール, PID_デモ用_視線設定用, PID_モーヴ)\n\nキャラカメラ(CharaCam_Shoulder_Left_Top, PID_モーヴ, cam_anim_track2_l_normal)
MID_RELIANCE_S_#012	キャラモーション再生(PID_リュール, Die)\n\n*\n\nキャラモーション再生(PID_リュール, Die, EmoGive,, 1)\n\nウェイト(0.7)
MID_RELIANCE_S_#013	キャラモーション再生(PID_リュール, Die, IdleNormal)\n\nキャラ視線(PID_リュール, PID_モーヴ, PID_モーヴ)\n\nキャラカメラ(CharaCam_Side_Right3_Mid, PID_モーヴ, cam_anim_pan_d_slow)
MID_RELIANCE_S_#014	キャラモーション再生(PID_リュール, Surprise, EmoDeny)\n\nキャラカメラ(CharaCam_Front_Center_Top, PID_リュール, cam_anim_pan_u_slow)
MID_RELIANCE_S_#015	キャラ視線(PID_リュール, PID_デモ用_視線設定用, PID_モーヴ)\n\n*\n\nキャラモーション再生(PID_モーヴ, Relax, EmoTired)\n\nウェイト(0.6)
MID_RELIANCE_S_#016	キャラモーション再生(PID_モーヴ, Sad)\nキャラモーション再生(PID_リュール, Surprise, IdleNormal,, 1)\n\n一枚絵表示(Tex_Event_ItemPicture_14, picture_item_fade_in_normal)\n\nキャラカメラ(CharaCam_Side_Right_Mid, PID_モーヴ, cam_anim_track_l_normal)\n\n*\n\nパペット会話中断()\n\nウェイト(1)\n\n一枚絵非表示(picture_item_fade_out_normal)\n\nウェイト(1)
MID_RELIANCE_S_#017	キャラモーション再生(PID_リュール, Sad, EmoThink)\nキャラモーション再生(PID_モーヴ, Sad, IdleNormal)\n\nキャラカメラ(CharaCam_Side_Left2_Mid, PID_リュール, cam_anim_track_r_normal)
MID_RELIANCE_S_#018	キャラモーション再生(PID_リュール, Sad, IdleNormal)\nキャラモーション再生(PID_モーヴ, Die)\n\nキャラ視線(PID_リュール, PID_モーヴ, PID_モーヴ)\n\nキャラカメラ(CharaCam_Front_Center2_Mid, PID_モーヴ, cam_anim_pan_d_slow)
MID_RELIANCE_S_#019	キャラモーション再生(PID_モーヴ, Normal, EmoTalk,, 0.3)
MID_RELIANCE_S_#020	キャラモーション再生(PID_リュール, Surprise)\nキャラモーション再生(PID_モーヴ, Normal, IdleNormal)\n\nキャラカメラ(CharaCam_Side_Left2_Mid, PID_リュール, cam_anim_track_r_slow)
MID_RELIANCE_S_#021	キャラモーション再生(PID_リュール, Sad)
MID_RELIANCE_S_#022	キャラカメラ(CharaCam_Shoulder_Left_Top, PID_モーヴ, cam_anim_zoom_in_slow)
MID_RELIANCE_S_#023	
MID_RELIANCE_S_#024	キャラカメラ(CharaCam_Side_Right3_Mid, PID_モーヴ, cam_anim_pan_d_slow)
MID_RELIANCE_S_#025	キャラモーション再生(PID_モーヴ, Normal, EmoDeny2, 3, 0.3)
MID_RELIANCE_S_#026	キャラモーション再生(PID_モーヴ, Normal, IdleNormal,, 1)\n\nシーンカメラ(SceneCam_SideMe_Right_Mid, cam_anim_zoom_in_slow)
MID_RELIANCE_S_#027	キャラモーション再生(PID_モーヴ, Normal, EmoRelax,, 0.3)
MID_RELIANCE_S_#028	キャラカメラ(CharaCam_Front_Center_Top, PID_モーヴ, cam_anim_pan_u_slow)
MID_RELIANCE_S_#029	キャラモーション再生(PID_リュール, Shy)\nキャラモーション再生(PID_モーヴ, Normal, IdleNormal)\n\nキャラカメラ(CharaCam_Side_Left3_Mid, PID_リュール, cam_anim_pan_d_normal)
MID_RELIANCE_S_#030	キャラカメラ(CharaCam_Side_Right2_Top, PID_モーヴ, cam_anim_track_l_slow)
MID_RELIANCE_S_#031	キャラモーション再生(PID_モーヴ, Normal, EmoTalk,, 0.3)
MID_RELIANCE_S_#032	キャラモーション再生(PID_モーヴ, Normal, IdleNormal)\n\nキャラカメラ(CharaCam_Side_Left2_Mid, PID_リュール, cam_anim_track_r_slow)
MID_RELIANCE_S_#033	キャラモーション再生(PID_リュール, Shy, EmoShy,, 0.3)
MID_RELIANCE_S_#034	キャラモーション再生(PID_モーヴ, Surprise)\nキャラモーション再生(PID_リュール, Shy, IdleNormal)\n\nキャラカメラ(CharaCam_Front_Center_Mid, PID_モーヴ, cam_anim_zoom_in_normal)
MID_RELIANCE_S_#035	キャラカメラ(CharaCam_Shoulder_Left_Top, PID_モーヴ, cam_anim_zoom_in_slow)
MID_RELIANCE_S_#036	キャラモーション再生(PID_リュール, Shy, EmoRelax,, 0.3)
MID_RELIANCE_S_#037	キャラモーション再生(PID_リュール, Sad)\n\nキャラカメラ(CharaCam_Side_Left2_Mid, PID_リュール, cam_anim_track_r_normal)
MID_RELIANCE_S_#038	キャラモーション再生(PID_モーヴ, Smile)\nキャラモーション再生(PID_リュール, Sad, IdleNormal)\n\nキャラカメラ(CharaCam_Side_Right2_Mid, PID_モーヴ, cam_anim_track_l_normal)
MID_RELIANCE_S_#039	キャラモーション再生(PID_リュール, Smile)\n\nキャラカメラ(CharaCam_Front_Center2_Mid, PID_リュール, cam_anim_pan_d_slow)
MID_RELIANCE_S_#040	
MID_RELIANCE_S_#041	キャラモーション再生(PID_リュール, Smile, EmoTalk)\n\nキャラカメラ(CharaCam_Shoulder_Left_Top, PID_モーヴ, cam_anim_track2_l_normal)
MID_RELIANCE_S_#042	キャラモーション再生(PID_モーヴ, Smile, EmoPray)\nキャラモーション再生(PID_リュール, Smile, IdleNormal)\n\nキャラカメラ(CharaCam_Side_Right3_Mid, PID_モーヴ, cam_anim_pan_d_normal)
MID_RELIANCE_S_#043	キャラモーション再生(PID_モーヴ, Smile, IdleNormal)\n\nキャラカメラ(CharaCam_Front_Center_Mid, PID_リュール, cam_anim_zoom_in_normal)
MID_RELIANCE_S_#044	キャラカメラ(CharaCam_Front_Center2_Mid, PID_モーヴ, cam_anim_pan_d_normal)\n\n*\n\nパペット会話中断()
MID_RELIANCE_S_#045	フェードアウト()\n一枚絵表示(Tex_Event_Reliance_S_35)\nウェイト(0.8)\n\nフェードイン()\nウェイト(1.2)\n\n*\n\nウェイト(1)\nフェードアウト()
