MID_RELIANCE_C_#001	キャラ配置(PID_リュール, YOU_IN_C, [服装], Normal, IdleNormal, 0)\nキャラ配置(PID_ロサード, ME_IN_C, [服装], Normal, IdleNormal, 0)\n\nキャラ配置調整(PID_ロサード, 0, 0, 0, -80)\n\n背景(Map_Event_Hub_Solanel_05_Day)\nライト(CharaLight_Hub_Day, 0, 0, 0)\n\nキャラ視線(PID_リュール, PID_ロサード, PID_ロサード)\n\nウェイト(1)\n\nキャラモーション再生(PID_リュール, Smile, WalkIn2)\n\nキャラカメラ(CharaCam_Shoulder_Left_Mid, PID_ロサード, cam_anim_track_l_normal)\n\nフェードイン()
MID_RELIANCE_C_#002	キャラモーション再生(PID_ロサード, Normal, TurnR,, 0.3)\nキャラモーション再生(PID_リュール, Smile, IdleNormal)\n\nキャラ回転(PID_ロサード, 80, 1.7)\n\nキャラ視線(PID_ロサード, PID_リュール, PID_リュール)\n\nキャラカメラ(CharaCam_Side_Right2_Top, PID_ロサード, cam_anim_zoom_in_normal)
MID_RELIANCE_C_#003	キャラモーション再生(PID_リュール, Smile, EmoNod)\nキャラモーション再生(PID_ロサード, Normal, IdleNormal)\n\nキャラカメラ(CharaCam_Front_Center2_Mid, PID_リュール, cam_anim_pan_d_slow)
MID_RELIANCE_C_#004	
MID_RELIANCE_C_#005	キャラモーション再生(PID_ロサード, Smile, EmoJoy)\nキャラモーション再生(PID_リュール, Smile, IdleNormal)\n\nキャラカメラ(CharaCam_Side_Right2_Mid, PID_ロサード, cam_anim_track_l_slow)
MID_RELIANCE_C_#006	キャラモーション再生(PID_ロサード, Normal)
MID_RELIANCE_C_#007	キャラモーション再生(PID_ロサード, Relax, EmoProud,, 1)
MID_RELIANCE_C_#008	キャラモーション再生(PID_ロサード, Relax, IdleNormal)\n\nキャラカメラ(CharaCam_Side_Left2_Mid, PID_リュール, cam_anim_track_r_slow)
MID_RELIANCE_C_#009	キャラモーション再生(PID_リュール, Smile, EmoRelax,, 0.3)
MID_RELIANCE_C_#010	キャラモーション再生(PID_ロサード, Smile, EmoSad2)\nキャラモーション再生(PID_リュール, Smile, IdleNormal)\n\nキャラカメラ(CharaCam_Front_Center_Top, PID_ロサード, cam_anim_pan_u_slow)
MID_RELIANCE_C_#011	
MID_RELIANCE_C_#012	キャラモーション再生(PID_ロサード, Normal)\n\nキャラカメラ(CharaCam_Shoulder_Right_Top, PID_リュール, cam_anim_track2_r_normal)
MID_RELIANCE_C_#013	キャラモーション再生(PID_ロサード, Sad, EmoThink,, 1)\n
MID_RELIANCE_C_#014	キャラモーション再生(PID_リュール, Smile, EmoNod,, 0.3)\nキャラモーション再生(PID_ロサード, Sad, IdleNormal)\n\nキャラカメラ(CharaCam_Front_Center_Top, PID_リュール, cam_anim_pan_u_normal)
MID_RELIANCE_C_#015	キャラモーション再生(PID_ロサード, Smile, EmoPray,, 0.3)\n\nキャラカメラ(CharaCam_Side_Right3_Mid, PID_ロサード, cam_anim_pan_d_normal)\n\n*\n\nフェードアウト()
MID_RELIANCE_B_#001	キャラ配置(PID_リュール, ME_IN_C, [服装], Normal, IdleNormal, 0)\nキャラ配置(PID_ロサード, YOU_IN_C, [服装], Normal, IdleNormal, 0)\n\n背景(Map_Event_M007_01)\nライト(CharaLight_M007, 0, 0, 0)\n\nキャラ視線(PID_ロサード, PID_リュール, PID_リュール)\n\nウェイト(1)\n\nキャラモーション再生(PID_リュール, Sad, EmoTired)\n\nキャラカメラ(CharaCam_Shoulder_Left_Mid, PID_ロサード, cam_anim_track2_l_normal)\n\nフェードイン()
MID_RELIANCE_B_#002	キャラモーション再生(PID_ロサード, Normal, EmoGive,, 0.3)\nキャラモーション再生(PID_リュール, Sad, IdleNormal)\n\nキャラ視線(PID_リュール, PID_ロサード, PID_ロサード)\n\nキャラカメラ(CharaCam_Front_Center_ Top, PID_ロサード, cam_anim_zoom_out_normal)
MID_RELIANCE_B_#003	キャラモーション再生(PID_ロサード, Normal, IdleNormal)\n\nキャラカメラ(CharaCam_Side_Left3_Mid, PID_リュール, cam_anim_pan_d_normal)\n\n*\n\nパペット会話中断()\n\nフェードアウト()\n\nウェイト(0.5)\n\nキャラモーション再生(PID_リュール, Die)\n\nウェイト(0.3)
MID_RELIANCE_B_#004	キャラカメラ(CharaCam_Side_Left2_Mid, PID_リュール, cam_anim_track_r_slow)\n\nフェードイン()
MID_RELIANCE_B_#005	キャラモーション再生(PID_リュール, Normal, EmoTalk,, 0.3)\n\nキャラ視線リセット(PID_ロサード)
MID_RELIANCE_B_#006	キャラモーション再生(PID_ロサード, Normal, EmoLook)\nキャラモーション再生(PID_リュール, Normal, IdleNormal)\n\nキャラカメラ(CharaCam_Side_Right2_Top, PID_ロサード, cam_anim_track_l_normal)
MID_RELIANCE_B_#007	キャラモーション再生(PID_リュール, Surprise)\nキャラモーション再生(PID_ロサード, Normal, IdleNormal)\n\nキャラ視線(PID_ロサード, PID_リュール, PID_リュール)\n\nキャラカメラ(CharaCam_Front_Center2_Mid, PID_リュール, cam_anim_pan_d_normal)
MID_RELIANCE_B_#008	キャラモーション再生(PID_ロサード, Normal, EmoNod,, 0.3)\n\nキャラカメラ(CharaCam_Shoulder_Right_Top, PID_リュール, cam_anim_track2_r_normal)
MID_RELIANCE_B_#009	キャラモーション再生(PID_ロサード, Shy)
MID_RELIANCE_B_#010	キャラモーション再生(PID_ロサード, Smile, EmoTalk,, 1)\n\nキャラカメラ(CharaCam_Side_Right3_Mid, PID_ロサード, cam_anim_pan_d_normal)
MID_RELIANCE_B_#011	キャラモーション再生(PID_ロサード, Smile, IdleNormal)\n\nキャラカメラ(CharaCam_Front_Center_Top, PID_リュール, cam_anim_pan_u_normal)
MID_RELIANCE_B_#012	キャラモーション再生(PID_ロサード, Normal, EmoNod,, 0.3)\n\nキャラカメラ(CharaCam_Side_Right2_Mid, PID_ロサード, cam_anim_track_l_normal)
MID_RELIANCE_B_#013	キャラモーション再生(PID_リュール, Normal, EmoThink)\nキャラモーション再生(PID_ロサード, Normal, IdleNormal)\n\nキャラカメラ(CharaCam_Side_Left2_Mid, PID_リュール, cam_anim_track_r_normal)
MID_RELIANCE_B_#014	キャラモーション再生(PID_ロサード, Shy, EmoRelax)\nキャラモーション再生(PID_リュール, Normal, IdleNormal)\n\nキャラカメラ(CharaCam_Side_Right3_Mid, PID_ロサード, cam_anim_pan_d_slow)
MID_RELIANCE_B_#015	キャラモーション再生(PID_ロサード, Smile)
MID_RELIANCE_B_#016	キャラモーション再生(PID_リュール, Smile, EmoRelax)\nキャラモーション再生(PID_ロサード, Smile,IdleNormal)\n\nキャラカメラ(CharaCam_Side_Left2_Top, PID_リュール, cam_anim_zoom_in_normal)
MID_RELIANCE_B_#017	キャラモーション再生(PID_ロサード, Normal, EmoProud)\nキャラモーション再生(PID_リュール, Smile, IdleNormal)\n\nキャラカメラ(CharaCam_Front_Center_Mid, PID_ロサード, cam_anim_zoom_out_slow)
MID_RELIANCE_B_#018	キャラモーション再生(PID_ロサード, Smile)
MID_RELIANCE_B_#019	キャラモーション再生(PID_リュール, Smile, EmoJoy)\nキャラモーション再生(PID_ロサード, Smile, IdleNormal)\n\nキャラカメラ(CharaCam_Front_Center2_Mid, PID_リュール, cam_anim_pan_d_normal)\n\n*\n\nフェードアウト()
MID_RELIANCE_A_#001	キャラ配置(PID_リュール, ME_IN_C, [服装], Normal, IdleNormal, 0)\nキャラ配置(PID_ロサード, YOU_IN_C, [服装], Normal, IdleNormal, 0)\n\n背景(Map_Event_Hub_Solanel_06_Day)\nライト(CharaLight_Hub_Day, 0, 0, 0)\n\nキャラ視線(PID_リュール, PID_ロサード, PID_ロサード)\nキャラ視線(PID_ロサード, PID_リュール, PID_リュール)\n\nウェイト(1)\n\nキャラモーション再生(PID_リュール, Smile, EmoTalk)\n\nキャラカメラ(CharaCam_Shoulder_Left_Mid, PID_ロサード, cam_anim_track2_l_normal)\n\nフェードイン()
MID_RELIANCE_A_#002	
MID_RELIANCE_A_#003	キャラモーション再生(PID_ロサード, Relax, EmoSad2,, 0.3)\nキャラモーション再生(PID_リュール, Smile, IdleNormal)\n\nキャラカメラ(CharaCam_Side_Right2_Mid, PID_ロサード, cam_anim_track_l_normal)
MID_RELIANCE_A_#004	キャラモーション再生(PID_リュール, Shy, EmoNod)\nキャラモーション再生(PID_ロサード, Relax, IdleNormal)\n\nキャラカメラ(CharaCam_Side_Left2_Mid, PID_リュール, cam_anim_track_r_slow)
MID_RELIANCE_A_#005	キャラモーション再生(PID_リュール, Sad, EmoSad, 3, 1)
MID_RELIANCE_A_#006	キャラモーション再生(PID_リュール, Smile, IdleNormal,, 1)\n\nキャラカメラ(CharaCam_Shoulder_Left_Mid, PID_ロサード, cam_anim_zoom_in_normal)
MID_RELIANCE_A_#007	キャラモーション再生(PID_ロサード, Normal)\n\nキャラカメラ(CharaCam_Side_Right2_Top, PID_ロサード, cam_anim_zoom_in_slow)
MID_RELIANCE_A_#008	キャラモーション再生(PID_ロサード, Relax, EmoDeny2,, 1)
MID_RELIANCE_A_#009	キャラモーション再生(PID_リュール, Normal)\nキャラモーション再生(PID_ロサード, Relax, IdleNormal)\n\nキャラカメラ(CharaCam_Side_Left3_Mid, PID_リュール, cam_anim_pan_d_normal)
MID_RELIANCE_A_#010	キャラモーション再生(PID_ロサード, Surprise)\n\nキャラカメラ(CharaCam_Front_Center_Top, PID_ロサード, cam_anim_pan_u_normal)
MID_RELIANCE_A_#011	キャラモーション再生(PID_リュール, Normal, EmoTalk)\n\nキャラカメラ(CharaCam_Front_Center2_Mid, PID_リュール, cam_anim_pan_d_normal)
MID_RELIANCE_A_#012	キャラモーション再生(PID_ロサード, Die, EmoSad2,, 0.3)\nキャラモーション再生(PID_リュール, Normal, IdleNormal)\n\nキャラカメラ(CharaCam_Side_Right2_Top, PID_ロサード, cam_anim_zoom_in_slow)
MID_RELIANCE_A_#013	キャラモーション再生(PID_ロサード, Normal)
MID_RELIANCE_A_#014	キャラモーション再生(PID_リュール, Normal, EmoNod)\nキャラモーション再生(PID_ロサード, Normal, IdleNormal)\n\nキャラカメラ(CharaCam_Side_Left2_Mid, PID_リュール, cam_anim_track_r_normal)
MID_RELIANCE_A_#015	キャラモーション再生(PID_ロサード, Sad, EmoSad,, 0.3)\nキャラモーション再生(PID_リュール, Normal, IdleNormal)\n\nキャラカメラ(CharaCam_Side_Right3_Mid, PID_ロサード, cam_anim_pan_d_slow)
MID_RELIANCE_A_#016	
MID_RELIANCE_A_#017	キャラモーション再生(PID_ロサード, Angry)\n\nキャラカメラ(CharaCam_FrontLong2_Right_Bot, PID_ロサード, cam_anim_pan_r_normal)
MID_RELIANCE_A_#018	キャラモーション再生(PID_ロサード, Angry, EmoTalk,, 1)
MID_RELIANCE_A_#019	キャラモーション再生(PID_リュール, Die, EmoRelax,, 0.3)\nキャラモーション再生(PID_リュール, Normal,, 4)\nキャラモーション再生(PID_ロサード, Angry, IdleNormal)\n\nキャラカメラ(CharaCam_Side_Left2_Top, PID_リュール, cam_anim_zoom_in_normal)
MID_RELIANCE_A_#020	キャラモーション再生(PID_ロサード, Shy, EmoShy,, 1)\nキャラモーション再生(PID_リュール, Normal, IdleNormal)\n\nキャラカメラ(CharaCam_Side_Right3_Mid, PID_ロサード, cam_anim_pan_d_slow)
MID_RELIANCE_A_#021	キャラモーション再生(PID_リュール, Smile, EmoDeny2)\nキャラモーション再生(PID_ロサード, Shy, IdleNormal)\n\nキャラカメラ(CharaCam_Front_Center_Top, PID_リュール, cam_anim_pan_u_normal)
MID_RELIANCE_A_#022	キャラモーション再生(PID_ロサード, Relax)\nキャラモーション再生(PID_リュール, Smile, IdleNormal)\n\nキャラカメラ(CharaCam_Front_Center2_Mid, PID_ロサード, cam_anim_pan_d_slow)
MID_RELIANCE_A_#023	キャラモーション再生(PID_ロサード, Smile, EmoProud,, 0.3)
MID_RELIANCE_A_#024	キャラモーション再生(PID_リュール, Smile, EmoNod)\nキャラモーション再生(PID_ロサード, Smile, IdleNormal)\n\nキャラカメラ(CharaCam_Side_Left3_Mid, PID_リュール, cam_anim_pan_d_normal)\n\n*\n\nフェードアウト()
MID_RELIANCE_S_#001	キャラ配置(PID_リュール, ME_IN_C, [服装], Normal, IdleNormal, 0)\nキャラ配置(PID_ロサード, YOU_IN_C, [服装], Normal, IdleNormal, 0)\n\n背景(Map_Event_Hub_Solanel_05_Day)\nライト(CharaLight_Hub_Day, 0, 0, 0)\n\nキャラ視線(PID_リュール, PID_ロサード, PID_ロサード)\nキャラ視線(PID_ロサード, PID_リュール, PID_リュール)\n\nウェイト(1)\n\nキャラモーション再生(PID_ロサード, Normal, EmoProud, 2, 0.3)\n\nキャラカメラ(CharaCam_Shoulder_Right_Top, PID_リュール, cam_anim_track2_r_normal)\n\nフェードイン()
MID_RELIANCE_S_#002	キャラモーション再生(PID_リュール, Smile, EmoNod,, 0.3)\nキャラモーション再生(PID_ロサード, Normal, IdleNormal)\n\nキャラカメラ(CharaCam_Side_Left3_Mid, PID_リュール, cam_anim_pan_d_normal)
MID_RELIANCE_S_#003	キャラモーション再生(PID_ロサード, Die, EmoNod,, 0.3)\nキャラモーション再生(PID_リュール, Smile, IdleNormal)\n\nキャラカメラ(CharaCam_Front_Center_Top, PID_ロサード, cam_anim_pan_u_slow)
MID_RELIANCE_S_#004	
MID_RELIANCE_S_#005	キャラモーション再生(PID_リュール, Normal, EmoThink)\nキャラモーション再生(PID_ロサード, Die, IdleNormal)\n\nキャラカメラ(CharaCam_Side_Left2_Mid, PID_リュール, cam_anim_track_r_normal)
MID_RELIANCE_S_#006	キャラモーション再生(PID_ロサード, Angry, EmoGive)\nキャラモーション再生(PID_リュール, Normal, IdleNormal)\n\nキャラカメラ(CharaCam_Side_Right_Mid, PID_ロサード, cam_anim_track_l_normal)
MID_RELIANCE_S_#007	キャラモーション再生(PID_リュール, Smile, EmoTalk)\nキャラモーション再生(PID_ロサード, Angry, IdleNormal)\n\nキャラカメラ(CharaCam_Front_Center_Top, PID_リュール, cam_anim_pan_u_normal)
MID_RELIANCE_S_#008	キャラモーション再生(PID_ロサード, Normal)\nキャラモーション再生(PID_リュール, Smile, IdleNormal)\n\nキャラカメラ(CharaCam_Side_Right2_Mid, PID_ロサード, cam_anim_track_l_normal)
MID_RELIANCE_S_#009	キャラモーション再生(PID_リュール, Smile, EmoRelax)\n\nキャラカメラ(CharaCam_Side_Left2_Mid, PID_リュール, cam_anim_track_r_normal)
MID_RELIANCE_S_#010	キャラモーション再生(PID_ロサード, Relax, EmoSad2)\nキャラモーション再生(PID_リュール, Smile, IdleNormal,, 1)\n\nキャラカメラ(CharaCam_Shoulder_Right_Mid, PID_リュール, cam_anim_zoom_in_normal)
MID_RELIANCE_S_#011	キャラモーション再生(PID_リュール, Surprise)\nキャラモーション再生(PID_ロサード, Relax, IdleNormal)\n\nキャラカメラ(CharaCam_Side_Left3_Mid, PID_リュール, cam_anim_pan_d_normal)
MID_RELIANCE_S_#012	キャラモーション再生(PID_ロサード, Normal)\n\nキャラカメラ(CharaCam_Front_Center2_Mid, PID_ロサード, cam_anim_pan_d_slow)
MID_RELIANCE_S_#013	キャラモーション再生(PID_ロサード, Normal, EmoTalk,, 0.3)\n\nキャラモーション再生(PID_ロサード, Angry,, 7.5)
MID_RELIANCE_S_#014	キャラモーション再生(PID_ロサード, Angry, IdleNormal)\n\nキャラカメラ(CharaCam_Side_Left2_Mid, PID_リュール, cam_anim_track_r_normal)\n\n*\n\nパペット会話中断()\n\nウェイト(1)
MID_RELIANCE_S_#015	キャラカメラ(CharaCam_Side_Right2_Top, PID_ロサード, cam_anim_track_l_slow)
MID_RELIANCE_S_#016	キャラモーション再生(PID_ロサード, Sad, EmoRelax,, 0.3)
MID_RELIANCE_S_#017	キャラモーション再生(PID_リュール, Smile)\nキャラモーション再生(PID_ロサード, Sad, IdleNormal)\n\nキャラカメラ(CharaCam_Front_Center_Top, PID_リュール, cam_anim_pan_u_normal)
MID_RELIANCE_S_#018	キャラカメラ(CharaCam_Front_Center2_Mid, PID_ロサード, cam_anim_pan_d_normal)
MID_RELIANCE_S_#019	キャラカメラ(CharaCam_Shoulder_Left_Mid, PID_ロサード, cam_anim_track2_l_normal)
MID_RELIANCE_S_#020	キャラモーション再生(PID_リュール, Smile, EmoRelax,, 0.3)
MID_RELIANCE_S_#021	キャラモーション再生(PID_ロサード, Surprise)\nキャラモーション再生(PID_リュール, Smile, IdleNormal)\n\nキャラカメラ(CharaCam_Side_Right2_Top, PID_ロサード, cam_anim_zoom_in_normal)
MID_RELIANCE_S_#022	キャラモーション再生(PID_リュール, Smile, EmoGive)\n\n一枚絵表示(Tex_Event_ItemPicture_14, picture_item_fade_in_normal)\n\nキャラカメラ(CharaCam_Side_Left_Mid, PID_リュール, cam_anim_track_r_normal)\n\n*\n\nパペット会話中断()\n\nウェイト(1)\n\n一枚絵非表示(picture_item_fade_out_normal)\n\nウェイト(1)
MID_RELIANCE_S_#023	キャラモーション再生(PID_ロサード, Surprise, EmoSad2)\nキャラモーション再生(PID_リュール, Smile, IdleNormal)\n\nキャラカメラ(CharaCam_Front_Center_Top, PID_ロサード, cam_anim_zoom_out_normal)
MID_RELIANCE_S_#024	キャラモーション再生(PID_ロサード, Angry, IdleNormal)\n\nキャラカメラ(CharaCam_Side_Left2_Mid, PID_リュール, cam_anim_track_r_normal)
MID_RELIANCE_S_#025	キャラモーション再生(PID_ロサード, Shy)\n\nキャラカメラ(CharaCam_Side_Right2_Mid, PID_ロサード, cam_anim_track_l_slow)
MID_RELIANCE_S_#026	キャラモーション再生(PID_ロサード, Shy, EmoSad,, 0.3)
MID_RELIANCE_S_#027	キャラモーション再生(PID_リュール, Smile, EmoNod)\nキャラモーション再生(PID_ロサード, Shy, IdleNormal)\n\nキャラカメラ(CharaCam_Front_Center_Top, PID_リュール, cam_anim_pan_u_normal)
MID_RELIANCE_S_#028	キャラモーション再生(PID_ロサード, Relax)\nキャラモーション再生(PID_リュール, Smile, IdleNormal)\n\nキャラカメラ(CharaCam_Front_Center2_Mid, PID_ロサード, cam_anim_pan_d_normal)\n\n*\n\nパペット会話中断()
MID_RELIANCE_S_#029	フェードアウト()\n一枚絵表示(Tex_Event_Reliance_S_20)\nウェイト(0.8)\n\nフェードイン()\nウェイト(1.2)\n\n*\n\nウェイト(1)\nフェードアウト()
