MID_RELIANCE_C_#001	キャラ配置(PID_グレゴリー, ME_IN_C,, Normal, IdleNormal)\nキャラ配置(PID_モーヴ, YOU_IN_C,, Normal, IdleNormal, -90)\n\nキャラ配置(PID_デモ用_視線設定用, YOU_IN_E)\nキャラ表示切替(PID_デモ用_視線設定用, False)\nキャラ配置調整(PID_デモ用_視線設定用,, -0.6)\n\n背景(Map_Event_Hub_Solanel_10_Day)\nライト(CharaLight_Hub_Day)\n\nキャラ視線(PID_グレゴリー, PID_モーヴ, PID_モーヴ)\nキャラ視線(PID_モーヴ, PID_デモ用_視線設定用, PID_デモ用_視線設定用)\n\nウェイト(0.4)\n\nキャラモーション再生(PID_モーヴ, Normal, EmoTalk2,,1)\n\nキャラカメラ(CharaCam_Side_Right_Mid, PID_モーヴ, cam_anim_pan_r_normal)\nフェードイン()
MID_RELIANCE_C_#002	キャラカメラ(CharaCam_Side_Left_Mid, PID_グレゴリー, cam_anim_pan_l_normal)\nキャラモーション再生(PID_モーヴ, Normal, IdleNormal)
MID_RELIANCE_C_#003	キャラカメラ(CharaCam_Side_Right_Mid, PID_モーヴ, cam_anim_pan_r_normal)\n\nキャラモーション再生(PID_モーヴ, Normal, EmoTalk,,1)
MID_RELIANCE_C_#004	キャラカメラ(CharaCam_Side_Left_Mid, PID_グレゴリー, cam_anim_pan_l_normal)\n\nキャラモーション再生(PID_グレゴリー, Normal, EmoNod,,1)\nキャラモーション再生(PID_グレゴリー, Normal, IdleNormal,1,1)\n\nキャラモーション再生(PID_モーヴ, Normal, IdleNormal)
MID_RELIANCE_C_#005	シーンカメラ(SceneCam_Side_Right_Mid, cam_anim_pan_u_normal)\n\nキャラモーション再生(PID_モーヴ, Normal, EmoTalk2,,1)\nキャラモーション再生(PID_モーヴ, Normal, EmoAngry, 4.5,1)\nキャラ視線(PID_モーヴ, PID_グレゴリー, PID_グレゴリー)
MID_RELIANCE_C_#006	\nキャラモーション再生(PID_グレゴリー, Normal, EmoNod,,1)\n\n*\nパペット会話中断()\nウェイト(2)\nキャラ視線(PID_モーヴ, PID_デモ用_視線設定用, PID_デモ用_視線設定用)
MID_RELIANCE_C_#007	キャラカメラ(CharaCam_SideLong_Right2_Mid, PID_モーヴ, cam_anim_track_r_normal)\n\nキャラモーション再生(PID_モーヴ, Die, EmoDeny2,,1)\nキャラモーション再生(PID_モーヴ, Normal,, 4,1)\nキャラモーション再生(PID_グレゴリー, Normal, IdleNormal)
MID_RELIANCE_C_#008	キャラ視線(PID_モーヴ, PID_グレゴリー, PID_グレゴリー)\n\nキャラモーション再生(PID_モーヴ, Normal, EmoTalk2,,1)
MID_RELIANCE_C_#009	キャラ視線(PID_モーヴ, PID_デモ用_視線設定用, PID_デモ用_視線設定用, 4)\nキャラモーション再生(PID_モーヴ, Angry, EmoDeny2,,1)\nキャラモーション再生(PID_モーヴ, Normal,, 4,1)
MID_RELIANCE_C_#010	キャラカメラ(CharaCam_Side_Left2_Mid, PID_グレゴリー, cam_anim_zoom_out_fast)\n\nキャラモーション再生(PID_グレゴリー, Surprise, EmoSurprise2,,0.3)\nキャラモーション再生(PID_モーヴ, Normal, IdleNormal)
MID_RELIANCE_C_#011	キャラカメラ(CharaCam_Shoulder_Right_Mid, PID_グレゴリー, cam_anim_track_r_normal)\n\nキャラ回転(PID_モーヴ, 40, 1)\nキャラ視線(PID_モーヴ, PID_グレゴリー, PID_グレゴリー)\n*\nパペット会話中断()\nウェイト(0.5)
MID_RELIANCE_C_#012	キャラカメラ(CharaCam_SideLong_Left2_Mid, PID_グレゴリー, cam_anim_pan_l_normal)\n\nキャラモーション再生(PID_グレゴリー, Sad, EmoDeny2,,1)\nキャラモーション再生(PID_グレゴリー, Normal, EmoTalk2, 3.3,1)\nキャラモーション再生(PID_モーヴ, Normal, IdleNormal)
MID_RELIANCE_C_#013	キャラカメラ(CharaCam_SideLong_Right2_Mid, PID_モーヴ, cam_anim_track_r_normal)\n\nキャラモーション再生(PID_モーヴ, Die, EmoSad,,0.5)\nキャラモーション再生(PID_モーヴ, Normal,, 5,1)\nキャラモーション再生(PID_グレゴリー, Normal, IdleNormal,,1)
MID_RELIANCE_C_#014	キャラモーション再生(PID_モーヴ, Normal, EmoThink, 3,1)
MID_RELIANCE_C_#015	シーンカメラ(SceneCam_Side_Right_Mid, cam_anim_track3_l_normal)\n\nキャラモーション再生(PID_モーヴ, Normal, IdleNormal,, 1)
MID_RELIANCE_C_#016	キャラモーション再生(PID_モーヴ, Normal,,,1)\nキャラモーション再生(PID_モーヴ, Normal, EmoTalk, 4.8,1)\nキャラモーション再生(PID_グレゴリー, Normal, IdleNormal,,1)
MID_RELIANCE_C_#017	キャラカメラ(CharaCam_Front_Center2_Mid, PID_グレゴリー, cam_anim_zoom_in_normal)\n\nキャラモーション再生(PID_グレゴリー, Normal, EmoThink,0.2,1)\nキャラモーション再生(PID_モーヴ, Normal, IdleNormal)
MID_RELIANCE_C_#018	キャラカメラ(CharaCam_Side_Right3_Mid, PID_モーヴ, cam_anim_pan_r_normal)\n\nキャラモーション再生(PID_モーヴ, Normal, EmoTalk2,,1)\nキャラモーション再生(PID_グレゴリー, Normal, IdleNormal)
MID_RELIANCE_C_#019	キャラカメラ(CharaCam_FrontLong2_Left_Mid, PID_グレゴリー, cam_anim_pan_l_normal)\n\nキャラモーション再生(PID_グレゴリー, Sad,,,1)\nキャラモーション再生(PID_モーヴ, Normal, IdleNormal,,1)
MID_RELIANCE_C_#020	キャラカメラ(CharaCam_Front_Center2_Mid, PID_グレゴリー, cam_anim_quake_w_once)\n\nキャラモーション再生(PID_グレゴリー, Serious, EmoPray,,0.3)\nキャラモーション再生(PID_グレゴリー, Sad,, 2,1)
MID_RELIANCE_C_#021	キャラカメラ(CharaCam_Side_Right_Mid, PID_モーヴ, cam_anim_zoom_in_fast)\n\nキャラモーション再生(PID_モーヴ, Surprise, EmoSurprise,,0.5)\nキャラ表示切替(PID_グレゴリー, False)\nキャラ配置調整(PID_グレゴリー, 0.2,, 0.6)\nキャラモーション再生(PID_グレゴリー, Normal, IdleNormal)
MID_RELIANCE_C_#022	キャラカメラ(CharaCam_Side_Left2_Mid, PID_グレゴリー, cam_anim_track_l_normal)\nキャラ表示切替(PID_グレゴリー, True)\nキャラ表示切替(PID_モーヴ, False)\n\nキャラモーション再生(PID_グレゴリー, Sad, EmoDeny,,1)\nキャラモーション再生(PID_グレゴリー, Serious, , 5.5,1)\nキャラモーション再生(PID_モーヴ, Normal, IdleNormal)
MID_RELIANCE_C_#023	キャラモーション再生(PID_グレゴリー, Sad, EmoRelax,,1)\nキャラモーション再生(PID_グレゴリー, Serious, EmoPray, 6,1)
MID_RELIANCE_C_#024	キャラカメラ(CharaCam_Side_Right_Mid, PID_モーヴ, cam_anim_zoom_in_normal)\nキャラ表示切替(PID_モーヴ, True)\nキャラモーション再生(PID_モーヴ, Surprise, EmoNod,,1)\nキャラモーション再生(PID_モーヴ, Sad,, 2,1)\n\n*\nキャラ視線(PID_モーヴ, PID_デモ用_視線設定用, PID_デモ用_視線設定用)\nキャラ回転(PID_モーヴ, -50, 1)\nウェイト(0.3)
MID_RELIANCE_C_#025	キャラカメラ(CharaCam_SideLong_Left2_Mid, PID_グレゴリー, cam_anim_pan_d_normal)\nキャラモーション再生(PID_グレゴリー, Shy,,, 1)\nキャラモーション再生(PID_グレゴリー, Shy, EmoProud, 0.5,1)\nキャラモーション再生(PID_モーヴ, Normal, IdleNormal,,1)\n\n*\nパペット会話中断()
MID_RELIANCE_C_#026	キャラカメラ(CharaCam_Shoulder_Left_Mid, PID_モーヴ, cam_anim_zoom_out_normal)\nキャラモーション再生(PID_グレゴリー, Normal, EmoNod,,1)\n\nウェイト(2)\nキャラ回転(PID_モーヴ, -20, 1, 4)\nキャラモーション再生(PID_モーヴ, Sad, EmoSad,,1)\nキャラモーション再生(PID_グレゴリー, Normal, EmoProud, 5,1)\n*\nフェードアウト()
MID_RELIANCE_B_#001	キャラ配置(PID_グレゴリー, YOU_IN_C,, Normal, IdleNormal)\nキャラ配置(PID_モーヴ, ME_IN_C,, Normal, IdleNormal)\n\n背景(Map_Event_Hub_Solanel_17_Day)\nライト(CharaLight_Hub_Day)\n\nキャラ視線(PID_グレゴリー, PID_モーヴ, PID_モーヴ)\nキャラ視線(PID_モーヴ, PID_グレゴリー, PID_グレゴリー)\n\nウェイト(0.4)\n\nキャラカメラ(CharaCam_FrontLong2_Right_Mid, PID_グレゴリー, cam_anim_track_r_normal)\nフェードイン()\n\nキャラモーション再生(PID_グレゴリー, Normal, EmoTalk,,0.3)
MID_RELIANCE_B_#002	キャラモーション再生(PID_グレゴリー, Normal, EmoThink, 2,1)
MID_RELIANCE_B_#003	キャラカメラ(CharaCam_Side_Left3_Mid, PID_モーヴ, cam_anim_zoom_in_normal)\n\nキャラモーション再生(PID_モーヴ, Normal, EmoTalk2,,1)\nキャラモーション再生(PID_グレゴリー, Normal, IdleNormal)
MID_RELIANCE_B_#004	キャラカメラ(CharaCam_SideLong_Right2_Mid, PID_グレゴリー, cam_anim_track_l_normal)\n\nキャラ表示切替(PID_モーヴ, False)\nキャラモーション再生(PID_グレゴリー, Smile, EmoJoy, 2,1)\nキャラモーション再生(PID_モーヴ, Normal, IdleNormal)
MID_RELIANCE_B_#005	キャラモーション再生(PID_グレゴリー, Die, EmoNod,,1)\nキャラモーション再生(PID_グレゴリー, Smile,, 2,1)
MID_RELIANCE_B_#006	キャラカメラ(CharaCam_Side_Left4_Mid, PID_モーヴ, cam_anim_pan_l_normal)\n\nキャラ表示切替(PID_モーヴ, True)\nキャラモーション再生(PID_モーヴ, Normal, EmoNod,,1)\nキャラモーション再生(PID_グレゴリー, Normal, IdleNormal)
MID_RELIANCE_B_#007	シーンカメラ(SceneCam_Side_Right_Mid, cam_anim_track3_r_normal)\n\nキャラモーション再生(PID_グレゴリー, Normal, EmoTalk2,,1)\nキャラモーション再生(PID_グレゴリー, Normal, EmoDeny, 3,0.5)\nキャラモーション再生(PID_モーヴ, Normal, IdleNormal,,1)
MID_RELIANCE_B_#008	キャラモーション再生(PID_モーヴ, Normal, EmoAngry,,0.5)
MID_RELIANCE_B_#009	キャラカメラ(CharaCam_Front_Center2_Mid, PID_グレゴリー, cam_anim_pan_d_normal)\n\nキャラモーション再生(PID_グレゴリー, Normal, EmoNod,,1)\nキャラモーション再生(PID_グレゴリー, Normal, EmoTalk, 2,1)\nキャラモーション再生(PID_モーヴ, Normal, IdleNormal)
MID_RELIANCE_B_#010	キャラカメラ(CharaCam_Side_Left2_Mid, PID_モーヴ, cam_anim_zoom_in_normal)\n\nキャラモーション再生(PID_モーヴ, Sad,,,1)\nキャラモーション再生(PID_グレゴリー, Normal, IdleNormal)
MID_RELIANCE_B_#011	キャラモーション再生(PID_モーヴ, Normal, EmoNod,,1)
MID_RELIANCE_B_#012	キャラカメラ(CharaCam_Side_Right3_Mid, PID_グレゴリー, cam_anim_pan_r_normal)\n\nキャラモーション再生(PID_グレゴリー, Sad, EmoDeny,,0.5)\nキャラモーション再生(PID_モーヴ, Normal, IdleNormal)
MID_RELIANCE_B_#013	キャラカメラ(CharaCam_FrontLong2_Left_Mid, PID_モーヴ, cam_anim_track_r_normal)\n\nキャラモーション再生(PID_モーヴ, Die, EmoDeny2,,1)\nキャラモーション再生(PID_モーヴ, Normal,, 4,1)\nキャラモーション再生(PID_グレゴリー, Normal, IdleNormal,,1)
MID_RELIANCE_B_#014	キャラモーション再生(PID_モーヴ, Normal, EmoTalk2,,1)\n
MID_RELIANCE_B_#015	キャラカメラ(CharaCam_Side_Right3_Mid, PID_グレゴリー, cam_anim_pan_r_normal)\nキャラモーション再生(PID_モーヴ, Normal, IdleNormal)
MID_RELIANCE_B_#016	キャラカメラ(CharaCam_LowFront_Left, PID_モーヴ, cam_anim_track3_r_normal)\n\nキャラモーション再生(PID_モーヴ, Normal, EmoRelax,,1)\nキャラモーション再生(PID_モーヴ, Normal, EmoDeny2, 6,1)\n\nキャラモーション再生(PID_グレゴリー, Normal, IdleNormal)
MID_RELIANCE_B_#017	キャラモーション再生(PID_モーヴ, Normal, EmoThink,,1)\n
MID_RELIANCE_B_#018	キャラカメラ(CharaCam_Side_Left3_Bot, PID_モーヴ, cam_anim_zoom_out_normal)\n\nキャラモーション再生(PID_モーヴ, Normal, EmoTalk,,1)\n
MID_RELIANCE_B_#019	キャラモーション再生(PID_モーヴ, Sad, EmoAngry,,1)\n
MID_RELIANCE_B_#020	キャラカメラ(CharaCam_SideLong_Right2_Mid, PID_グレゴリー, cam_anim_pan_d_normal)\n\nキャラモーション再生(PID_グレゴリー, Surprise, EmoProud,,0.3)\nキャラモーション再生(PID_グレゴリー, Pain, EmoDeny2, 3,1)\nキャラモーション再生(PID_モーヴ, Normal, IdleNormal,,1)
MID_RELIANCE_B_#021	キャラモーション再生(PID_グレゴリー, Normal, EmoTalk2,,1)
MID_RELIANCE_B_#022	キャラカメラ(CharaCam_Side_Left4_Mid, PID_モーヴ, cam_anim_pan_l_normal)\n\nキャラモーション再生(PID_モーヴ, Die, EmoPray,,1)\nキャラモーション再生(PID_モーヴ, Sad, EmoDeny2, 5,1)\nキャラモーション再生(PID_グレゴリー, Normal, IdleNormal)
MID_RELIANCE_B_#023	キャラカメラ(CharaCam_FrontLong2_Right_Mid, PID_グレゴリー, cam_anim_track_r_normal)\n\nキャラモーション再生(PID_グレゴリー, Normal, EmoThink,,1)\nキャラモーション再生(PID_グレゴリー, Sad, EmoTalk, 4,1)\nキャラモーション再生(PID_モーヴ, Normal, IdleNormal,,1)
MID_RELIANCE_B_#024	キャラカメラ(CharaCam_Front_Center_Mid, PID_モーヴ, cam_anim_pan_d_normal)\n\nキャラモーション再生(PID_モーヴ, Serious,,,1)\nキャラモーション再生(PID_グレゴリー, Normal, IdleNormal)
MID_RELIANCE_B_#025	キャラモーション再生(PID_モーヴ, Normal, EmoTalk2,,1)
MID_RELIANCE_B_#026	キャラカメラ(CharaCam_Side_Right_Mid, PID_グレゴリー, cam_anim_zoom_in_fast)\n\nキャラモーション再生(PID_グレゴリー, Angry,,,1)\nキャラモーション再生(PID_モーヴ, Normal, IdleNormal)
MID_RELIANCE_B_#027	キャラカメラ(CharaCam_SideLong_Left2_Mid, PID_モーヴ, cam_anim_track_r_normal)\n\nキャラモーション再生(PID_モーヴ, Sad, EmoSad,,1)\nキャラモーション再生(PID_モーヴ, Normal, EmoRelax, 6,1)\nキャラモーション再生(PID_グレゴリー, Normal, IdleNormal,,1)
MID_RELIANCE_B_#028	キャラモーション再生(PID_モーヴ, Die,,,1)\nキャラモーション再生(PID_モーヴ, Sad, EmoTalk2, 4,1)
MID_RELIANCE_B_#029	キャラカメラ(CharaCam_Side_Right2_Top, PID_グレゴリー, cam_anim_track_l_normal)\n\nキャラモーション再生(PID_グレゴリー, Serious, EmoDeny,,1)\nキャラモーション再生(PID_グレゴリー, Shy,, 4.3,1)\nキャラモーション再生(PID_モーヴ, Normal, IdleNormal)
MID_RELIANCE_B_#030	キャラモーション再生(PID_グレゴリー, Sad,,,1)\nキャラモーション再生(PID_グレゴリー, Shy, EmoTalk, 3.3,1)\n\n*\nキャラカメラ(CharaCam_FrontLong2_Left_Mid, PID_モーヴ, cam_anim_zoom_out_normal)\nキャラ視線リセット(PID_グレゴリー)\nキャラ視線リセット(PID_モーヴ)\nキャラ回転(PID_グレゴリー, -30, 1.4)\nキャラモーション再生(PID_グレゴリー, Sad,TurnR,,0.5)\nキャラモーション再生(PID_グレゴリー, Sad, WalkOut, 0.5,1)\nキャラモーション再生(PID_モーヴ, Normal, TurnR, 1.8,2)\nキャラ回転(PID_モーヴ, 100, 3.5, 1.8)\nウェイト(4)
MID_RELIANCE_B_#031	\n\n*\nフェードアウト()
MID_RELIANCE_A_#001	キャラ配置(PID_グレゴリー, YOU_IN_C,, Normal, IdleNormal)\nキャラ配置(PID_モーヴ, ME_IN_C,, Normal, IdleNormal)\n\nキャラ配置(PID_デモ用_視線設定用, YOU_IN_B)\nキャラ表示切替(PID_デモ用_視線設定用, False)\nキャラ配置調整(PID_デモ用_視線設定用, 0.8, -0.4, -1)\n\n背景(Map_Event_Hub_Solanel_04_Day)\nライト(CharaLight_Hub_Day)\n\nキャラ視線(PID_グレゴリー, PID_モーヴ, PID_モーヴ)\nキャラ視線(PID_モーヴ, PID_グレゴリー, PID_グレゴリー)\n\nウェイト(0.4)\n\nキャラカメラ(CharaCam_FrontLong2_Left_Mid, PID_モーヴ, cam_anim_zoom_out_normal)\nフェードイン()\n\nキャラモーション再生(PID_モーヴ, Normal, EmoTalk,,1)
MID_RELIANCE_A_#002	キャラモーション再生(PID_グレゴリー, Sad,,,1)\nキャラモーション再生(PID_モーヴ, Normal, IdleNormal)\n\nキャラカメラ(CharaCam_Side_Right2_Mid, PID_グレゴリー, cam_anim_pan_r_normal)
MID_RELIANCE_A_#003	キャラモーション再生(PID_モーヴ, Sad, EmoTalk2,,1)\nキャラモーション再生(PID_グレゴリー, Normal, IdleNormal)\n\nキャラカメラ(CharaCam_SideLong_Left2_Mid, PID_モーヴ, cam_anim_track_r_normal)\n
MID_RELIANCE_A_#004	キャラモーション再生(PID_モーヴ, Die, EmoDeny2,,1)\nキャラモーション再生(PID_モーヴ, Sad,, 3.5,1)
MID_RELIANCE_A_#005	キャラモーション再生(PID_グレゴリー, Smile,,,1)\nキャラモーション再生(PID_グレゴリー, Smile, EmoTalk, 1,1)\nキャラモーション再生(PID_モーヴ, Normal, IdleNormal)\n\nキャラカメラ(CharaCam_Side_Right3_Top, PID_グレゴリー, cam_anim_zoom_in_normal)\n\n
MID_RELIANCE_A_#006	キャラ視線(PID_グレゴリー, PID_デモ用_視線設定用, PID_デモ用_視線設定用)\nキャラモーション再生(PID_グレゴリー, Sad, IdleNormal,,1)\nキャラモーション再生(PID_グレゴリー, Die, EmoRelax, 2,1)\n
MID_RELIANCE_A_#007	キャラモーション再生(PID_モーヴ, Normal, EmoRelax,,1)\nキャラモーション再生(PID_モーヴ,, EmoTalk, 5,1)\nキャラ視線(PID_グレゴリー, PID_モーヴ, PID_モーヴ)\nキャラモーション再生(PID_グレゴリー, Normal, IdleNormal)\n\nキャラカメラ(CharaCam_Side_Left_Mid, PID_モーヴ, cam_anim_pan_l_normal)
MID_RELIANCE_A_#008	キャラモーション再生(PID_グレゴリー, Angry, EmoSurprise2,,0.3)\nキャラモーション再生(PID_モーヴ, Normal, IdleNormal)\nキャラ表示切替(PID_モーヴ, False)\n\nキャラカメラ(CharaCam_SideLong_Right2_Mid, PID_グレゴリー, cam_anim_track_l_normal)
MID_RELIANCE_A_#009	キャラ視線(PID_グレゴリー, PID_デモ用_視線設定用, PID_デモ用_視線設定用)\nキャラモーション再生(PID_グレゴリー, Sad,,,1)\nキャラモーション再生(PID_グレゴリー, Angry, EmoDeny2, 3.9,1)\nキャラ視線(PID_グレゴリー, PID_モーヴ, PID_モーヴ, 3.9)
MID_RELIANCE_A_#010	キャラモーション再生(PID_モーヴ, Normal, EmoNod,,1)\nキャラモーション再生(PID_モーヴ,, EmoTalk2, 6,1)\nキャラモーション再生(PID_グレゴリー, Normal, IdleNormal)\nキャラ表示切替(PID_モーヴ, True)\nキャラ視線(PID_グレゴリー, PID_モーヴ, PID_モーヴ)\n\nキャラカメラ(CharaCam_Side_Left3_Mid, PID_モーヴ, cam_anim_zoom_in_normal)
MID_RELIANCE_A_#011	キャラモーション再生(PID_モーヴ, Die, EmoRelax,,1)\nキャラモーション再生(PID_モーヴ, Normal,, 3,1)
MID_RELIANCE_A_#012	キャラモーション再生(PID_グレゴリー, Shy,,,1)\nキャラモーション再生(PID_グレゴリー, Shy, EmoTalk, 3,1)\nキャラモーション再生(PID_モーヴ, Normal, IdleNormal)\n\nキャラカメラ(CharaCam_Front_Center_Top, PID_グレゴリー, cam_anim_zoom_out_normal)
MID_RELIANCE_A_#013	キャラモーション再生(PID_グレゴリー, Smile, EmoRelax,,1)
MID_RELIANCE_A_#014	キャラモーション再生(PID_モーヴ, Surprise,,,0.5)\nキャラモーション再生(PID_グレゴリー, Normal, IdleNormal)\n\nキャラカメラ(CharaCam_Side_Left2_Mid, PID_モーヴ, cam_anim_pan_d_normal)
MID_RELIANCE_A_#015	キャラモーション再生(PID_グレゴリー, Angry, EmoDeny,,1)\nキャラモーション再生(PID_モーヴ, Normal, IdleNormal)\n\nキャラカメラ(CharaCam_FrontLong2_Right_Mid, PID_グレゴリー, cam_anim_track2_r_normal)
MID_RELIANCE_A_#016	キャラモーション再生(PID_モーヴ, Normal, EmoShy,,1)\nキャラモーション再生(PID_グレゴリー, Normal, IdleNormal)\n\nキャラカメラ(CharaCam_Side_Left4_Mid, PID_モーヴ, cam_anim_zoom_out_normal)
MID_RELIANCE_A_#017	キャラモーション再生(PID_モーヴ, Die,,,1)\nキャラモーション再生(PID_モーヴ, Normal, EmoThink, 4,1)
MID_RELIANCE_A_#018	キャラモーション再生(PID_グレゴリー, Smile, EmoJoy,,0.5)\nキャラモーション再生(PID_モーヴ, Normal, IdleNormal)\n\nキャラカメラ(CharaCam_Side_Right2_Mid, PID_グレゴリー, cam_anim_zoom_in_normal)
MID_RELIANCE_A_#019	キャラモーション再生(PID_グレゴリー, Sad, EmoDeny2,,0.5)
MID_RELIANCE_A_#020	キャラモーション再生(PID_モーヴ, Smile,,,1)\nキャラモーション再生(PID_グレゴリー, Normal, IdleNormal)\n\nキャラカメラ(CharaCam_Front_Center2_Mid, PID_モーヴ, cam_anim_zoom_in_normal)
MID_RELIANCE_A_#021	キャラモーション再生(PID_モーヴ, Normal, IdleNormal)\n\nキャラカメラ(CharaCam_Side_Right_Mid, PID_グレゴリー, cam_anim_pan_r_normal)
MID_RELIANCE_A_#022	キャラモーション再生(PID_グレゴリー, Normal, IdleNormal)\n\nキャラカメラ(CharaCam_Side_Left3_Mid, PID_モーヴ, cam_anim_zoom_in_normal)
MID_RELIANCE_A_#023	キャラモーション再生(PID_グレゴリー, Shy, EmoTalk,,1)\nキャラモーション再生(PID_モーヴ, Normal, IdleNormal)\n\nキャラカメラ(CharaCam_Side_Right2_Mid, PID_グレゴリー, cam_anim_track_l_normal)
MID_RELIANCE_A_#024	キャラモーション再生(PID_モーヴ, Die, EmoNod,,1)\nキャラモーション再生(PID_グレゴリー, Normal, IdleNormal,,1)\n\nキャラカメラ(CharaCam_FrontLong2_Left_Bot, PID_モーヴ, cam_anim_zoom_in_normal)\n
MID_RELIANCE_A_#025	キャラモーション再生(PID_グレゴリー, Smile, EmoJoy,,0.3)\nキャラモーション再生(PID_モーヴ, Normal, IdleNormal)\nキャラ表示切替(PID_モーヴ, False)\n\nキャラカメラ(CharaCam_SideLong_Right2_Mid, PID_グレゴリー, cam_anim_pan_u_normal)
MID_RELIANCE_A_#026	キャラモーション再生(PID_グレゴリー, Smile, EmoTalk, ,1)
MID_RELIANCE_A_#027	キャラモーション再生(PID_モーヴ, Smile, EmoTalk2,,1)\nキャラモーション再生(PID_グレゴリー, Normal, IdleNormal)\nキャラ表示切替(PID_モーヴ, True)\n\nキャラカメラ(CharaCam_Front_Center2_Mid, PID_モーヴ, cam_anim_zoom_out_normal)\n\n*\nフェードアウト()
