MID_RELIANCE_C_#001	キャラ配置(PID_スタルーク, YOU_IN_C,, Normal, IdleNormal)\nキャラ配置(PID_シトリニカ, ME_IN_C,, Sad, IdleNormal, 75)\n\nキャラ配置(PID_デモ用_視線設定用, YOU_IN_E)\nキャラ配置調整(PID_デモ用_視線設定用, 0, -0.2, 0)\nキャラ表示切替(PID_デモ用_視線設定用, False)\n\n背景(Map_Event_Hub_Solanel_07_Day)\nライト(CharaLight_Hub_Day)\n\nキャラ視線(PID_スタルーク, PID_シトリニカ, PID_シトリニカ)\n\nキャラ表示切替(PID_スタルーク, False)\n\n一枚絵表示(Tex_Event_Effect_Black)\nフェードイン()\n\n*\nパペット会話中断()\nウェイト(1.5)
MID_RELIANCE_C_#002	キャラカメラ(CharaCam_SideLong_Left2_Mid, PID_シトリニカ, cam_anim_track3_r_normal)\n一枚絵非表示()\n\nキャラモーション再生(PID_シトリニカ, , EmoSad,,1)\n*\nキャラモーション再生(PID_シトリニカ, Normal, IdleNormal,,1)\nキャラ表示切替(PID_スタルーク, True)
MID_RELIANCE_C_#003	キャラカメラ(CharaCam_FrontLong2_Right_Mid, PID_スタルーク, cam_anim_pan_r_normal)\nキャラモーション再生(PID_スタルーク, , WalkIn2)\n\nキャラ視線(PID_シトリニカ, PID_スタルーク, PID_スタルーク, 1)\n*\nキャラモーション再生(PID_スタルーク, Sad, IdleNormal,,1)\nキャラ視線(PID_シトリニカ, PID_スタルーク, PID_スタルーク)
MID_RELIANCE_C_#004	キャラカメラ(CharaCam_FrontLong2_Left_Top, PID_シトリニカ, cam_anim_pan_r_slow)\nキャラモーション再生(PID_シトリニカ, Normal, TurnL,, 0.3)\nキャラモーション再生(PID_シトリニカ, , EmoTalk2, 1, 1)\nキャラ回転(PID_シトリニカ, -75, 1.2)\n*\nキャラモーション再生(PID_シトリニカ, Normal, IdleNormal)
MID_RELIANCE_C_#005	キャラカメラ(CharaCam_Side_Right2_Mid, PID_スタルーク, cam_anim_track_l_normal)\nキャラモーション再生(PID_スタルーク, , EmoDeny,,1)\n*\nキャラモーション再生(PID_スタルーク, Relax, IdleNormal)
MID_RELIANCE_C_#006	キャラカメラ(CharaCam_Side_Left2_Mid, PID_シトリニカ, cam_anim_track_r_normal)\nキャラモーション再生(PID_シトリニカ, , EmoRelax,,1)\n*\nキャラモーション再生(PID_シトリニカ, Relax, IdleNormal)
MID_RELIANCE_C_#007	キャラカメラ(CharaCam_SideLong_Right2_Mid, PID_スタルーク, cam_anim_track3_l_normal)\nキャラモーション再生(PID_スタルーク, , EmoTalk,,1)
MID_RELIANCE_C_#008	*\nキャラモーション再生(PID_スタルーク, Relax, IdleNormal,,1)
MID_RELIANCE_C_#009	キャラカメラ(CharaCam_FrontLong2_Left_Top, PID_シトリニカ, cam_anim_pan_l_normal)\nキャラモーション再生(PID_シトリニカ, , EmoRelax,,1)
MID_RELIANCE_C_#010	キャラモーション再生(PID_シトリニカ, Normal, EmoThink,,1)
MID_RELIANCE_C_#011	キャラカメラ(CharaCam_Side_Left3_Top, PID_シトリニカ, cam_anim_zoom_in_slow)\nキャラモーション再生(PID_シトリニカ, , EmoPray,,1)\nキャラ視線リセット(PID_シトリニカ)\n*\nキャラモーション再生(PID_シトリニカ, Normal, IdleNormal,,1)\nキャラ視線(PID_シトリニカ, PID_スタルーク, PID_スタルーク)
MID_RELIANCE_C_#012	キャラカメラ(CharaCam_FrontLong2_Right_Mid, PID_スタルーク, cam_anim_pan_r_normal)\nキャラモーション再生(PID_スタルーク, , EmoJoy, 2, 1)\n*\nキャラモーション再生(PID_スタルーク, Normal, IdleNormal,,1)
MID_RELIANCE_C_#013	キャラカメラ(CharaCam_FrontLong2_Left_Top, PID_シトリニカ, cam_anim_track3_r_normal)\nキャラモーション再生(PID_シトリニカ, , EmoTalk2,,1)
MID_RELIANCE_C_#014	キャラカメラ(CharaCam_Side_Left2_Mid, PID_シトリニカ, cam_anim_track_r_normal)\nキャラモーション再生(PID_シトリニカ, , EmoDeny,,1)
MID_RELIANCE_C_#015	キャラモーション再生(PID_シトリニカ, Sad)\n*\nキャラモーション再生(PID_シトリニカ, Normal, IdleNormal,,1)
MID_RELIANCE_C_#016	キャラカメラ(CharaCam_FrontLong2_Right_Mid, PID_スタルーク, cam_anim_pan_r_normal)\n*\nキャラモーション再生(PID_スタルーク, Normal, IdleNormal,,1)
MID_RELIANCE_C_#017	キャラカメラ(CharaCam_FrontLong2_Left_Top, PID_シトリニカ, cam_anim_pan_l_normal)\nキャラモーション再生(PID_シトリニカ, , EmoDeny2,,1)
MID_RELIANCE_C_#018	キャラモーション再生(PID_シトリニカ, , EmoTalk2,,1)\n*\nキャラモーション再生(PID_シトリニカ, Normal, IdleNormal)
MID_RELIANCE_C_#019	キャラカメラ(CharaCam_Side_Right3_Mid, PID_スタルーク, cam_anim_zoom_in_slow)\nキャラ視線リセット(PID_スタルーク)
MID_RELIANCE_C_#020	キャラカメラ(CharaCam_Shoulder_Left_Top, PID_スタルーク, cam_anim_track_l_normal)\nキャラ回転(PID_スタルーク, 181, 1.5)\nキャラモーション再生(PID_スタルーク, , TurnL,, 0.3)\n\nキャラ視線(PID_スタルーク, PID_デモ用_視線設定用, PID_デモ用_視線設定用, 1)\n*\nフェードアウト()
MID_RELIANCE_B_#001	キャラ配置(PID_スタルーク, YOU_IN_C,, Normal, IdleNormal, -30)\nキャラ配置(PID_シトリニカ, ME_IN_C,, Sad, IdleNormal, 75)\n\n背景(Map_Event_Hub_Solanel_07_Day)\nライト(CharaLight_Hub_Day)\n\nキャラ視線(PID_スタルーク, PID_シトリニカ, PID_シトリニカ)\n\nキャラ表示切替(PID_スタルーク, False)\n\nキャラカメラ(CharaCam_FrontLong2_Left_Top, PID_シトリニカ, cam_anim_track_r_normal)\nフェードイン()\n\nキャラモーション再生(PID_シトリニカ, , EmoTired,,1)
MID_RELIANCE_B_#002	キャラモーション再生(PID_シトリニカ, , EmoSad,,1)\n*\nキャラモーション再生(PID_シトリニカ, Surprise, IdleNormal,,1)\nキャラ表示切替(PID_スタルーク, True)
MID_RELIANCE_B_#003	キャラカメラ(CharaCam_ShoulderLong_Left_Mid, PID_シトリニカ, cam_anim_zoom_in_normal)\nキャラモーション再生(PID_スタルーク, , WalkIn2)\nキャラ回転(PID_スタルーク, 30, 1, 1.5)\n\nキャラ視線(PID_シトリニカ, PID_スタルーク, PID_スタルーク, 1)\n*\nキャラモーション再生(PID_スタルーク, Normal, IdleNormal,,1)\nキャラ視線(PID_シトリニカ, PID_スタルーク, PID_スタルーク)
MID_RELIANCE_B_#004	キャラカメラ(CharaCam_FrontLong2_Left_Top, PID_シトリニカ, cam_anim_pan_r_normal)\nキャラモーション再生(PID_シトリニカ, Surprise, TurnL,, 0.3)\nキャラ回転(PID_シトリニカ, -75, 1.3)\n*\nキャラ表示切替(PID_シトリニカ, False)\nキャラモーション再生(PID_シトリニカ,, IdleNormal)
MID_RELIANCE_B_#005	キャラカメラ(CharaCam_SideLong_Right2_Mid, PID_スタルーク, cam_anim_track3_r_normal)\nキャラモーション再生(PID_スタルーク, , EmoTalk,,1)
MID_RELIANCE_B_#006	キャラモーション再生(PID_スタルーク, , EmoDeny2,,1)\n*\nキャラモーション再生(PID_スタルーク, Normal, IdleNormal)\nキャラ表示切替(PID_シトリニカ, True)
MID_RELIANCE_B_#007	キャラカメラ(CharaCam_Side_Left_Mid, PID_シトリニカ, cam_anim_dolly_l_normal)
MID_RELIANCE_B_#008	キャラモーション再生(PID_シトリニカ, , EmoRelax,,1)
MID_RELIANCE_B_#009	キャラカメラ(CharaCam_FrontLong2_Left_Top, PID_シトリニカ, cam_anim_track3_l_normal)\nキャラモーション再生(PID_シトリニカ, , EmoTalk2,,1)
MID_RELIANCE_B_#010	*\nキャラモーション再生(PID_シトリニカ, Smile, IdleNormal,,1)
MID_RELIANCE_B_#011	キャラカメラ(CharaCam_FrontLong2_Right_Mid, PID_スタルーク, cam_anim_pan_r_normal)\nキャラモーション再生(PID_スタルーク, , EmoShy,,1)\n*\nキャラモーション再生(PID_スタルーク, Shy, IdleNormal)
MID_RELIANCE_B_#012	キャラカメラ(CharaCam_SideLong_Left2_Mid, PID_シトリニカ, cam_anim_track3_r_normal)\nキャラモーション再生(PID_シトリニカ, , EmoRelax,,1)
MID_RELIANCE_B_#013	
MID_RELIANCE_B_#014	
MID_RELIANCE_B_#015	キャラカメラ(CharaCam_FrontLong2_Left_Top, PID_シトリニカ, cam_anim_pan_r_normal)\nキャラモーション再生(PID_シトリニカ, , EmoTalk2,,1)\n*\nキャラモーション再生(PID_シトリニカ, Normal, IdleNormal)
MID_RELIANCE_B_#016	キャラカメラ(CharaCam_Side_Right3_Mid, PID_スタルーク, cam_anim_zoom_in_slow)\nキャラモーション再生(PID_スタルーク, , EmoDeny2,,1)\n*\nキャラモーション再生(PID_スタルーク, Sad, IdleNormal)
MID_RELIANCE_B_#017	キャラカメラ(CharaCam_Side_Left3_Top, PID_シトリニカ, cam_anim_zoom_in_slow)\nキャラモーション再生(PID_シトリニカ, , EmoPray,,1)
MID_RELIANCE_B_#018	キャラモーション再生(PID_シトリニカ, , EmoDeny,,1)
MID_RELIANCE_B_#019	キャラモーション再生(PID_シトリニカ, Sad, IdleNormal,,1)\nキャラ視線(PID_シトリニカ, PID_スタルーク, PID_スタルーク)\n*\nキャラモーション再生(PID_シトリニカ, , IdleNormal,,1)\nキャラ視線リセット(PID_シトリニカ)
MID_RELIANCE_B_#020	キャラカメラ(CharaCam_FrontLong2_Right_Mid, PID_スタルーク, cam_anim_pan_r_normal)\nキャラモーション再生(PID_スタルーク, , EmoDeny,,1)\n*\nキャラモーション再生(PID_スタルーク, , IdleNormal,,1)
MID_RELIANCE_B_#021	キャラカメラ(CharaCam_FrontLong2_Left_Top, PID_シトリニカ, cam_anim_pan_l_normal)\nキャラモーション再生(PID_シトリニカ, , EmoSad,,1)
MID_RELIANCE_B_#022	キャラモーション再生(PID_シトリニカ, , EmoRelax,,1)\n*\nキャラモーション再生(PID_シトリニカ, Normal, IdleNormal)
MID_RELIANCE_B_#023	キャラカメラ(CharaCam_Side_Right3_Mid, PID_スタルーク, cam_anim_zoom_in_slow)\n*\nフェードアウト()
MID_RELIANCE_A_#001	キャラ配置(PID_スタルーク, YOU_IN_C,, Normal, IdleNormal)\nキャラ配置(PID_シトリニカ, ME_IN_C,, Normal, IdleNormal)\n\n背景(Map_Event_Hub_Solanel_07_Evening)\nライト(CharaLight_Hub_Evening)\n\nキャラ視線(PID_スタルーク, PID_シトリニカ, PID_シトリニカ)\nキャラ視線(PID_シトリニカ, PID_スタルーク, PID_スタルーク)\n\nウェイト(0.3)\n\nキャラカメラ(CharaCam_FrontLong2_Right_Mid, PID_スタルーク, cam_anim_pan_r_normal)\nフェードイン()
MID_RELIANCE_A_#002	キャラカメラ(CharaCam_FrontLong2_Left_Top, PID_シトリニカ, cam_anim_pan_l_normal)
MID_RELIANCE_A_#003	キャラカメラ(CharaCam_FrontLong2_Right_Mid, PID_スタルーク, cam_anim_track3_l_normal)\nキャラモーション再生(PID_スタルーク, , EmoTalk,,1)
MID_RELIANCE_A_#004	キャラモーション再生(PID_スタルーク, , EmoDeny2,,1)\n*\nキャラモーション再生(PID_スタルーク, Normal, IdleNormal)
MID_RELIANCE_A_#005	キャラカメラ(CharaCam_Side_Left2_Top, PID_シトリニカ, cam_anim_track_r_normal)\n*\nキャラモーション再生(PID_シトリニカ, Normal, IdleNormal,,1)
MID_RELIANCE_A_#006	キャラカメラ(CharaCam_FrontLong2_Right_Mid, PID_スタルーク, cam_anim_pan_l_normal)\nキャラモーション再生(PID_スタルーク, , EmoTalk,,1)\n*\nキャラモーション再生(PID_スタルーク, Normal, IdleNormal)
MID_RELIANCE_A_#007	キャラカメラ(CharaCam_SideLong_Left2_Mid, PID_シトリニカ, cam_anim_pan_u_slow)\nキャラモーション再生(PID_シトリニカ, , EmoDeny,,1)\nキャラ視線リセット(PID_シトリニカ)
MID_RELIANCE_A_#008	キャラモーション再生(PID_シトリニカ, Sad)\n*\nキャラモーション再生(PID_シトリニカ, , IdleNormal)
MID_RELIANCE_A_#009	キャラカメラ(CharaCam_Side_Right3_Mid, PID_スタルーク, cam_anim_zoom_in_slow)\nキャラモーション再生(PID_スタルーク, , EmoNod,,1)\nキャラモーション再生(PID_スタルーク, , IdleNormal, 1, 1)
MID_RELIANCE_A_#010	キャラモーション再生(PID_スタルーク, , EmoTalk,,1)
MID_RELIANCE_A_#011	キャラカメラ(CharaCam_SideLong_Right2_Mid, PID_スタルーク, cam_anim_track3_l_normal)
MID_RELIANCE_A_#012	キャラモーション再生(PID_スタルーク, Relax, EmoJoy,,1)\n*\nキャラモーション再生(PID_スタルーク, , IdleNormal,,1)
MID_RELIANCE_A_#013	キャラカメラ(CharaCam_FrontLong2_Left_Top, PID_シトリニカ, cam_anim_pan_l_normal)\nキャラモーション再生(PID_シトリニカ, , EmoDeny,,1)\n*\nキャラモーション再生(PID_シトリニカ, Normal, IdleNormal,,1)\nキャラ視線(PID_シトリニカ, PID_スタルーク, PID_スタルーク)
MID_RELIANCE_A_#014	キャラカメラ(CharaCam_FrontLong2_Right_Mid, PID_スタルーク, cam_anim_pan_r_normal)\nキャラモーション再生(PID_スタルーク, , EmoDeny2,,1)
MID_RELIANCE_A_#015	キャラモーション再生(PID_スタルーク, , EmoTalk,,1)\n*\nキャラモーション再生(PID_スタルーク, , IdleNormal)
MID_RELIANCE_A_#016	キャラカメラ(CharaCam_Side_Left3_Mid, PID_シトリニカ, cam_anim_track_l_normal)\n*\nキャラモーション再生(PID_シトリニカ, Normal, IdleNormal,,1)
MID_RELIANCE_A_#017	キャラカメラ(CharaCam_FrontLong2_Right_Mid, PID_スタルーク, cam_anim_pan_l_normal)\nキャラモーション再生(PID_スタルーク, , EmoRelax,,1)
MID_RELIANCE_A_#018	キャラモーション再生(PID_スタルーク, , EmoTalk,,1)
MID_RELIANCE_A_#019	キャラカメラ(CharaCam_SideLong_Right2_Mid, PID_スタルーク, cam_anim_track3_l_normal)\nキャラモーション再生(PID_スタルーク, , EmoPray,,1)
MID_RELIANCE_A_#020	
MID_RELIANCE_A_#021	キャラカメラ(CharaCam_FrontLong2_Right_Mid, PID_スタルーク, cam_anim_pan_l_slow)\nキャラモーション再生(PID_スタルーク, , EmoDeny2,,1)
MID_RELIANCE_A_#022	キャラモーション再生(PID_スタルーク, , EmoTalk,,1)\n*\nキャラモーション再生(PID_スタルーク, Smile, IdleNormal)
MID_RELIANCE_A_#023	キャラカメラ(CharaCam_Side_Left2_Top, PID_シトリニカ, cam_anim_track_r_normal)\n*\nキャラモーション再生(PID_シトリニカ, Smile, IdleNormal,,1)
MID_RELIANCE_A_#024	キャラカメラ(CharaCam_FrontLong2_Right_Mid, PID_スタルーク, cam_anim_track3_l_normal)\nキャラモーション再生(PID_スタルーク, , EmoNod,,1)\nキャラモーション再生(PID_スタルーク, , IdleNormal, 1, 1)
MID_RELIANCE_A_#025	キャラモーション再生(PID_スタルーク, , EmoRelax,,1)\n*\nキャラモーション再生(PID_スタルーク, , IdleNormal,,1)
MID_RELIANCE_A_#026	キャラカメラ(CharaCam_FrontLong2_Left_Top, PID_シトリニカ, cam_anim_pan_l_normal)
MID_RELIANCE_A_#027	キャラモーション再生(PID_シトリニカ, , EmoJoy,,1)
MID_RELIANCE_A_#028	キャラカメラ(CharaCam_Side_Left3_Mid, PID_シトリニカ, cam_anim_track_l_normal)\n*\nキャラモーション再生(PID_シトリニカ, , IdleNormal)
MID_RELIANCE_A_#029	キャラカメラ(CharaCam_Side_Right3_Mid, PID_スタルーク, cam_anim_zoom_in_slow)\nキャラモーション再生(PID_スタルーク, , EmoJoy,,1)\n*\nキャラモーション再生(PID_スタルーク, Normal, IdleNormal)
MID_RELIANCE_A_#030	キャラカメラ(CharaCam_Side_Left3_Mid, PID_シトリニカ, cam_anim_zoom_in_slow)\nキャラモーション再生(PID_シトリニカ, , EmoNod,,1)\n*\nフェードアウト()
