MID_RELIANCE_C_#001	キャラ配置(PID_スタルーク, ME_IN_C, [服装], Normal, IdleNormal, 0)\nキャラ配置(PID_フォガート, YOU_IN_C, [服装], Normal, IdleNormal, 0)\n\n背景(Map_Event_Hub_Solanel_18_Day)\nライト(CharaLight_Hub_Day, 0, 0, 0)\n\nキャラ視線(PID_スタルーク, PID_フォガート, PID_フォガート)\nキャラ視線(PID_フォガート, PID_スタルーク, PID_スタルーク)\n\nキャラモーション再生(PID_スタルーク, Normal, WalkIn2)\nキャラモーション再生(PID_スタルーク, Surprise, EmoSurprise, 1, 0.5)\n\nキャラカメラ(CharaCam_Side_Left2_Top, PID_スタルーク, cam_anim_track_r_normal)\n\nフェードイン()\n\nウェイト(0.3)
MID_RELIANCE_C_#002	キャラモーション再生(PID_フォガート, Sad, WalkIn2)\n\nキャラカメラ(CharaCam_Shoulder_Right_Mid, PID_スタルーク, cam_anim_track2_r_normal)
MID_RELIANCE_C_#003	キャラモーション再生(PID_スタルーク, Sad, IdleNormal,, 1)\nキャラモーション再生(PID_フォガート, Sad, IdleNormal)\n\nキャラカメラ(CharaCam_Front_Center_Mid, PID_スタルーク, cam_anim_zoom_out_normal)
MID_RELIANCE_C_#004	キャラモーション再生(PID_フォガート, Smile, EmoSad)\nキャラモーション再生(PID_スタルーク, Sad, IdleNormal)\n\nキャラカメラ(CharaCam_Front_Center_Top, PID_フォガート, cam_anim_pan_u_slow)
MID_RELIANCE_C_#005	キャラモーション再生(PID_フォガート, Normal)
MID_RELIANCE_C_#006	キャラモーション再生(PID_フォガート, Normal, EmoTalk,, 1)\n\nキャラカメラ(CharaCam_Shoulder_Right_Mid, PID_スタルーク, cam_anim_track2_r_normal)
MID_RELIANCE_C_#007	キャラモーション再生(PID_スタルーク, Normal)\nキャラモーション再生(PID_フォガート, Normal, IdleNormal)\n\nキャラカメラ(CharaCam_Side_Left2_Mid, PID_スタルーク, cam_anim_track_r_slow)
MID_RELIANCE_C_#008	キャラモーション再生(PID_スタルーク, Sad)
MID_RELIANCE_C_#009	キャラモーション再生(PID_フォガート, Sad, EmoThink)\nキャラモーション再生(PID_スタルーク, Sad, IdleNormal)\n\nキャラカメラ(CharaCam_Side_Right2_Mid, PID_フォガート, cam_anim_track_l_normal)
MID_RELIANCE_C_#010	キャラモーション再生(PID_スタルーク, Sad, EmoThink)\nキャラモーション再生(PID_フォガート, Sad, IdleNormal)\n\nキャラカメラ(CharaCam_Side_Left2_Top, PID_スタルーク, cam_anim_zoom_in_slow)
MID_RELIANCE_C_#011	
MID_RELIANCE_C_#012	キャラモーション再生(PID_スタルーク, Sad, IdleNormal)\n\nキャラカメラ(CharaCam_Front_Center_Mid, PID_フォガート, cam_anim_zoom_out_slow)
MID_RELIANCE_C_#013	キャラモーション再生(PID_フォガート, Relax, EmoTalk2,, 0.3)
MID_RELIANCE_C_#014	キャラモーション再生(PID_スタルーク, Surprise, EmoSurprise)\nキャラモーション再生(PID_スタルーク, Sad,, 1)\nキャラモーション再生(PID_フォガート, Relax, IdleNormal)\n\nキャラカメラ(CharaCam_Side_Left3_Top, PID_スタルーク, cam_anim_pan_d_slow)
MID_RELIANCE_C_#015	キャラモーション再生(PID_スタルーク, Sad)
MID_RELIANCE_C_#016	キャラモーション再生(PID_フォガート, Normal, EmoTalk,, 0.3)\nキャラモーション再生(PID_スタルーク, Sad, IdleNormal)\n\nキャラ視線リセット(PID_スタルーク)\n\nキャラカメラ(CharaCam_Side_Right2_Top, PID_フォガート, cam_anim_zoom_in_normal)
MID_RELIANCE_C_#017	キャラモーション再生(PID_スタルーク, Sad, EmoSad)\nキャラモーション再生(PID_フォガート, Normal, IdleNormal,, 1)\n\nキャラカメラ(CharaCam_Shoulder_Left_Top, PID_フォガート, cam_anim_track2_l_normal)
MID_RELIANCE_C_#018	
MID_RELIANCE_C_#019	キャラモーション再生(PID_スタルーク, Sad, IdleNormal,, 1)\n\nキャラカメラ(CharaCam_Front_Center2_Mid, PID_スタルーク, cam_anim_pan_d_slow)
MID_RELIANCE_C_#020	\n*\n\nキャラモーション再生(PID_スタルーク, Sad, TurnL,, 0.3)\nキャラモーション再生(PID_スタルーク, Sad, RunOut, 0.3, 1)\n\nキャラ回転(PID_スタルーク, 181, 1.2)\n\nウェイト(1.2)
MID_RELIANCE_C_#021	キャラモーション再生(PID_フォガート, Smile)\n\nキャラカメラ(CharaCam_Front_Center2_Mid, PID_フォガート, cam_anim_zoom_in_normal)\n\n*\n\nフェードアウト()
MID_RELIANCE_B_#001	キャラ配置(PID_スタルーク, ME_IN_C, [服装], Normal, IdleNormal, 0)\nキャラ配置(PID_フォガート, YOU_IN_C, [服装], Normal, IdleNormal, 0)\nキャラ配置(PID_デモ用_視線設定用, ME_IN_A, [服装], Normal, IdleNormal, 0)\n\nキャラ配置調整(PID_デモ用_視線設定用, -1, 0, 0.6, 0)\n\n背景(Map_Event_Hub_Solanel_01_Day)\nライト(CharaLight_Hub_Day, 0, 0, 0)\n\nキャラ視線(PID_スタルーク, PID_フォガート, PID_フォガート)\nキャラ視線(PID_フォガート, PID_スタルーク, PID_スタルーク)\n\nウェイト(1)\n\nキャラカメラ(CharaCam_Shoulder_Left_Mid, PID_スタルーク, cam_anim_track2_l_normal)\n\nフェードイン()
MID_RELIANCE_B_#002	キャラモーション再生(PID_スタルーク, Normal, EmoThinkIn,, 0.3)\n\nキャラカメラ(CharaCam_Side_Right2_Mid, PID_スタルーク, cam_anim_track_l_normal)
MID_RELIANCE_B_#003	キャラモーション再生(PID_スタルーク, Normal, EmoThinkLoop)\n\nキャラカメラ(CharaCam_Side_Left2_Mid, PID_フォガート, cam_anim_track_r_slow)
MID_RELIANCE_B_#004	
MID_RELIANCE_B_#005	キャラモーション再生(PID_フォガート, Relax)\nキャラモーション再生(PID_フォガート, Relax, EmoTalk, 2.3, 0.3)
MID_RELIANCE_B_#006	キャラモーション再生(PID_スタルーク, Normal, EmoThinkOut)\nキャラモーション再生(PID_フォガート, Relax, IdleNormal)\n\nキャラカメラ(CharaCam_Front_Center2_Mid, PID_スタルーク, cam_anim_pan_d_normal)
MID_RELIANCE_B_#007	キャラモーション再生(PID_フォガート, Normal, EmoNod)\nキャラモーション再生(PID_スタルーク, Normal, IdleNormal)\n\nキャラカメラ(CharaCam_Front_Center_Top, PID_フォガート, cam_anim_pan_u_normal)
MID_RELIANCE_B_#008	キャラモーション再生(PID_スタルーク, Normal, EmoRelax)\nキャラモーション再生(PID_フォガート, Normal, IdleNormal,, 1)\n\nキャラカメラ(CharaCam_Shoulder_Right_Mid, PID_フォガート, cam_anim_track2_r_normal)
MID_RELIANCE_B_#009	
MID_RELIANCE_B_#010	キャラモーション再生(PID_スタルーク, Normal, IdleNormal,, 1)\n\nキャラカメラ(CharaCam_Front_Center_Top, PID_スタルーク, cam_anim_pan_u_slow)
MID_RELIANCE_B_#011	キャラモーション再生(PID_スタルーク, Sad, EmoSad, 3, 0.3)
MID_RELIANCE_B_#012	キャラモーション再生(PID_フォガート, Sad, EmoThink,, 0.3)\nキャラモーション再生(PID_スタルーク, Sad, IdleNormal)\n\nキャラカメラ(CharaCam_Side_Left2_Mid, PID_フォガート, cam_anim_track_r_normal)
MID_RELIANCE_B_#013	キャラモーション再生(PID_フォガート, Sad, IdleNormal)\n\nキャラカメラ(CharaCam_Side_Right2_Mid, PID_スタルーク, cam_anim_track_l_normal)
MID_RELIANCE_B_#014	キャラモーション再生(PID_フォガート, Angry)\nキャラモーション再生(PID_フォガート, Normal, EmoTalk2, 3, 0.3)\n\nキャラカメラ(CharaCam_Front_Center_Mid, PID_フォガート, cam_anim_zoom_out_normal)
MID_RELIANCE_B_#015	キャラモーション再生(PID_スタルーク, Normal, EmoDeny2,, 0.3)\nキャラモーション再生(PID_フォガート, Normal, IdleNormal)\n\nキャラカメラ(CharaCam_Side_Right3_Mid, PID_スタルーク, cam_anim_pan_d_slow)
MID_RELIANCE_B_#016	キャラモーション再生(PID_スタルーク, Normal, IdleNormal,, 1)
MID_RELIANCE_B_#017	キャラモーション再生(PID_スタルーク, Sad)\nキャラモーション再生(PID_スタルーク, Sad, EmoSad, 2, 0.3)\n\nキャラカメラ(CharaCam_Shoulder_Right_Mid, PID_フォガート, cam_anim_track2_r_normal)
MID_RELIANCE_B_#018	キャラモーション再生(PID_スタルーク, Sad, IdleNormal)\n\nキャラカメラ(CharaCam_Side_Left2_Mid, PID_フォガート, cam_anim_track_r_slow)
MID_RELIANCE_B_#019	キャラモーション再生(PID_フォガート, Smile)\nキャラモーション再生(PID_フォガート, Smile, EmoNod, 3.3, 0.3)
MID_RELIANCE_B_#020	キャラモーション再生(PID_スタルーク, Sad, EmoSurprise)\nキャラモーション再生(PID_フォガート, Smile, IdleNormal)\n\nキャラカメラ(CharaCam_Side_Right2_Mid, PID_スタルーク, cam_anim_track_l_slow)
MID_RELIANCE_B_#021	
MID_RELIANCE_B_#022	キャラモーション再生(PID_スタルーク, Sad, IdleNormal,, 1)
MID_RELIANCE_B_#023	キャラモーション再生(PID_スタルーク, Sad, EmoRelax,, 0.3)\n\nキャラカメラ(CharaCam_Shoulder_Right_Mid, PID_フォガート, cam_anim_track_r_slow)\n\n*\n\nパペット会話中断()\n\nキャラモーション再生(PID_スタルーク, Sad, TurnL,, 0.5)\nキャラモーション再生(PID_スタルーク, Sad, RunOut, 0.5, 1)\nキャラモーション再生(PID_フォガート, Normal, TurnR, 0.7, 0.3)\n\nキャラ視線(PID_スタルーク, PID_デモ用_視線設定用, PID_デモ用_視線設定用)\nキャラ視線(PID_フォガート, PID_デモ用_視線設定用, PID_デモ用_視線設定用, 0.7)\n\nキャラ回転(PID_スタルーク, 280, 1.2)\n\nウェイト(0.7)\n\nキャラ回転(PID_フォガート, 70, 1.5)\n\nウェイト(1)
MID_RELIANCE_B_#024	キャラモーション再生(PID_フォガート, Normal, EmoWave, 2, 0.3)\n\n*\n\nフェードアウト()
MID_RELIANCE_A_#001	キャラ配置(PID_スタルーク, YOU_IN_C, [服装], Normal, IdleNormal, 0)\nキャラ配置(PID_フォガート, ME_IN_C, [服装], Normal, IdleNormal, 0)\n\nキャラ配置調整(PID_スタルーク, 0, 0, 0, -110)\n\n背景(Map_Event_Hub_Solanel_03_Evening)\nライト(CharaLight_Hub_Evening, 0, 0, 0)\n\nキャラ視線(PID_フォガート, PID_スタルーク, PID_スタルーク)\n\nキャラモーション再生(PID_フォガート, Normal, WalkIn2)\n\nキャラカメラ(CharaCam_ShoulderLong_Left_Bot, PID_スタルーク, cam_anim_zoom_in_normal)\n\nフェードイン()
MID_RELIANCE_A_#002	キャラモーション再生(PID_スタルーク, Surprise, TurnR,, 0.3)\nキャラモーション再生(PID_フォガート, Normal, IdleNormal)\n\nキャラ回転(PID_スタルーク, 110, 1.2)\n\nキャラ視線(PID_スタルーク, PID_フォガート, PID_フォガート)\n\nキャラカメラ(CharaCam_Side_Right2_Mid, PID_スタルーク, cam_anim_track_l_normal)
MID_RELIANCE_A_#003	キャラモーション再生(PID_フォガート, Shy)\nキャラモーション再生(PID_スタルーク, Surprise, IdleNormal)\n\nキャラカメラ(CharaCam_Side_Left2_Mid, PID_フォガート, cam_anim_track_r_normal)
MID_RELIANCE_A_#004	キャラモーション再生(PID_スタルーク, Sad, EmoRelax,, 0.3)\n\nキャラカメラ(CharaCam_Front_Center_Top, PID_スタルーク, cam_anim_zoom_out_slow)
MID_RELIANCE_A_#005	
MID_RELIANCE_A_#006	キャラモーション再生(PID_フォガート, Normal)\nキャラモーション再生(PID_スタルーク, Sad, IdleNormal,, 1)\n\nキャラカメラ(CharaCam_Shoulder_Left_Mid, PID_スタルーク, cam_anim_track2_l_normal)
MID_RELIANCE_A_#007	キャラモーション再生(PID_フォガート, Normal, EmoThink,, 0.3)
MID_RELIANCE_A_#008	キャラカメラ(CharaCam_Front_Center_Top, PID_フォガート, cam_anim_pan_u_slow)
MID_RELIANCE_A_#009	キャラモーション再生(PID_フォガート, Normal, IdleNormal,, 1)
MID_RELIANCE_A_#010	キャラモーション再生(PID_フォガート, Relax, EmoTalk,, 0.5)
MID_RELIANCE_A_#011	キャラモーション再生(PID_スタルーク, Normal)\nキャラモーション再生(PID_フォガート, Relax, IdleNormal)\n\nキャラカメラ(CharaCam_Side_Right3_Mid, PID_スタルーク, cam_anim_pan_d_normal)
MID_RELIANCE_A_#012	キャラモーション再生(PID_スタルーク, Normal, EmoThink,, 0.3)
MID_RELIANCE_A_#013	キャラモーション再生(PID_スタルーク, Normal, IdleNormal,, 1)\n\nキャラカメラ(CharaCam_Shoulder_Right_Mid, PID_フォガート, cam_anim_track2_r_normal)
MID_RELIANCE_A_#014	キャラモーション再生(PID_スタルーク, Smile)
MID_RELIANCE_A_#015	キャラモーション再生(PID_フォガート, Smile)\n\nキャラカメラ(CharaCam_Front_Center2_Mid, PID_フォガート, cam_anim_zoom_in_normal)
MID_RELIANCE_A_#016	キャラモーション再生(PID_スタルーク, Sad, EmoSurprise)\n\nキャラカメラ(CharaCam_Front_Center2_Mid, PID_スタルーク, cam_anim_pan_d_normal)
MID_RELIANCE_A_#017	キャラモーション再生(PID_フォガート, Sad, EmoSad,, 0.3)\nキャラモーション再生(PID_スタルーク, Sad, IdleNormal)\n\nキャラカメラ(CharaCam_Side_Left2_Mid, PID_フォガート, cam_anim_track_r_slow)
MID_RELIANCE_A_#018	キャラモーション再生(PID_フォガート, Normal)
MID_RELIANCE_A_#019	キャラモーション再生(PID_フォガート, Normal, IdleNormal)\n\nキャラカメラ(CharaCam_Side_Right2_Mid, PID_スタルーク, cam_anim_track_l_normal)
MID_RELIANCE_A_#020	キャラカメラ(CharaCam_Front_Center_Mid, PID_フォガート, cam_anim_zoom_out_slow)
MID_RELIANCE_A_#021	キャラモーション再生(PID_フォガート, Smile,, 2)
MID_RELIANCE_A_#022	キャラモーション再生(PID_フォガート, Smile, IdleNormal)\n\nキャラカメラ(CharaCam_Front_Center2_Mid, PID_スタルーク, cam_anim_zoom_in_slow)
MID_RELIANCE_A_#023	キャラモーション再生(PID_スタルーク, Smile, EmoNod,, 0.3)\nキャラモーション再生(PID_スタルーク, Smile, IdleNormal, 1, 1)
MID_RELIANCE_A_#024	キャラカメラ(CharaCam_Shoulder_Right_Mid, PID_フォガート, cam_anim_track2_r_normal)
MID_RELIANCE_A_#025	キャラモーション再生(PID_スタルーク, Smile, EmoRelax,, 0.3)
MID_RELIANCE_A_#026	キャラモーション再生(PID_スタルーク, Smile, IdleNormal)\n\nキャラカメラ(CharaCam_Side_Left2_Mid, PID_フォガート, cam_anim_track_r_normal)
MID_RELIANCE_A_#027	キャラモーション再生(PID_スタルーク, Surprise)\nキャラモーション再生(PID_スタルーク, Sad,, 2.3)\n\nキャラカメラ(CharaCam_Side_Right2_Mid, PID_スタルーク, cam_anim_track_l_slow)
MID_RELIANCE_A_#028	キャラモーション再生(PID_スタルーク, Sad, EmoSad,, 0.3)
MID_RELIANCE_A_#029	キャラモーション再生(PID_フォガート, Normal)\nキャラモーション再生(PID_フォガート, Smile, EmoTalk2, 5, 0.3)\nキャラモーション再生(PID_スタルーク, Sad, IdleNormal)\n\nキャラカメラ(CharaCam_Side_Left3_Mid, PID_フォガート, cam_anim_pan_d_normal)
MID_RELIANCE_A_#030	キャラモーション再生(PID_スタルーク, Surprise)\nキャラモーション再生(PID_スタルーク, Relax,, 1.7)\nキャラモーション再生(PID_フォガート, Smile, IdleNormal)\n\nキャラカメラ(CharaCam_Front_Center2_Mid, PID_スタルーク, cam_anim_zoom_in_slow)
MID_RELIANCE_A_#031	キャラモーション再生(PID_スタルーク, Relax)\nキャラモーション再生(PID_スタルーク, Smile,, 1.5, 0.3)\n\n*\n\nフェードアウト()
