MID_RELIANCE_C_#001	キャラ配置(PID_スタルーク, ME_IN_C,, Normal, IdleNormal)\nキャラ配置(PID_セアダス, YOU_IN_C,, Normal, IdleNormal)\n\n背景(Map_Event_Hub_Solanel_03_Day)\nライト(CharaLight_Hub_Day)\n\nキャラ視線(PID_スタルーク, PID_セアダス ,PID_セアダス)\nキャラ視線(PID_セアダス, PID_スタルーク, PID_スタルーク)\n\nウェイト(0.4)\n\nキャラカメラ(CharaCam_Shoulder_Right_Mid, PID_セアダス, cam_anim_track3_l_normal)\nフェードイン()\n\nキャラモーション再生(PID_スタルーク, , EmoTalk,,1)\n*\nキャラモーション再生(PID_スタルーク, Normal, IdleNormal,,1)
MID_RELIANCE_C_#002	キャラカメラ(CharaCam_FrontLong2_Left_Mid, PID_セアダス, cam_anim_pan_l_normal)\nキャラモーション再生(PID_セアダス, , EmoTalk2,,1)\n*\nキャラモーション再生(PID_セアダス, Normal, IdleNormal)
MID_RELIANCE_C_#003	キャラカメラ(CharaCam_Side_Right2_Mid, PID_スタルーク, cam_anim_track_l_normal)\nキャラモーション再生(PID_スタルーク, , EmoThinkIn,,1)
MID_RELIANCE_C_#004	キャラモーション再生(PID_スタルーク, , EmoThinkOut,,1)\n*\nキャラモーション再生(PID_スタルーク, Smile, IdleNormal)
MID_RELIANCE_C_#005	キャラカメラ(CharaCam_SideLong_Left2_Mid, PID_セアダス, cam_anim_track3_r_normal)\nキャラモーション再生(PID_セアダス, , EmoNod,,1)
MID_RELIANCE_C_#006	キャラモーション再生(PID_セアダス, , EmoTalk,,1)\n*\nキャラモーション再生(PID_セアダス, Surprise, IdleNormal)
MID_RELIANCE_C_#007	キャラカメラ(CharaCam_Side_Right3_Mid, PID_スタルーク, cam_anim_zoom_in_slow)\nキャラモーション再生(PID_スタルーク, , EmoNod,,1)\n*\nキャラモーション再生(PID_スタルーク, Normal, IdleNormal)
MID_RELIANCE_C_#008	キャラカメラ(CharaCam_Side_Left2_Mid, PID_セアダス, cam_anim_track_r_normal)\nキャラモーション再生(PID_セアダス, , EmoThink,,1)\n*\nキャラモーション再生(PID_セアダス, Normal, IdleNormal,,1)
MID_RELIANCE_C_#009	キャラカメラ(CharaCam_FrontLong2_Right_Mid, PID_スタルーク, cam_anim_pan_r_normal)\nキャラモーション再生(PID_スタルーク, , EmoShy,,1)\n*\nキャラモーション再生(PID_スタルーク, Relax, IdleNormal)
MID_RELIANCE_C_#010	キャラカメラ(CharaCam_Side_Left2_Mid, PID_セアダス, cam_anim_track_r_normal)\nキャラモーション再生(PID_セアダス, , EmoNod,,1)\n*\nキャラモーション再生(PID_セアダス, Relax, IdleNormal,,1)
MID_RELIANCE_C_#011	キャラカメラ(CharaCam_FrontLong2_Right_Mid, PID_スタルーク, cam_anim_pan_r_normal)\nキャラモーション再生(PID_スタルーク, , EmoTalk,,1)\n*\nキャラ表示切替(PID_スタルーク, False)\nキャラモーション再生(PID_スタルーク, Smile, IdleNormal)
MID_RELIANCE_C_#012	キャラカメラ(CharaCam_SideLong_Left2_Mid, PID_セアダス, cam_anim_track3_l_normal)\nキャラモーション再生(PID_セアダス, , EmoTalk,,1)
MID_RELIANCE_C_#013	キャラモーション再生(PID_セアダス, , EmoTalk2,,1)\n*\nキャラモーション再生(PID_セアダス, Normal, IdleNormal)\nキャラ表示切替(PID_スタルーク, True)
MID_RELIANCE_C_#014	キャラカメラ(CharaCam_Side_Right3_Mid, PID_スタルーク, cam_anim_zoom_in_slow)\nキャラモーション再生(PID_スタルーク, , EmoNod,,1)\n*\nキャラモーション再生(PID_スタルーク, Sad, IdleNormal,,1)
MID_RELIANCE_C_#015	キャラカメラ(CharaCam_FrontLong2_Left_Mid, PID_セアダス, cam_anim_pan_l_normal)\nキャラモーション再生(PID_セアダス, , EmoThink,,1)
MID_RELIANCE_C_#016	キャラモーション再生(PID_セアダス, , EmoDeny,,1)\n*\nキャラモーション再生(PID_セアダス, Normal, IdleNormal)
MID_RELIANCE_C_#017	キャラカメラ(CharaCam_Side_Right3_Top, PID_スタルーク, cam_anim_zoom_in_slow)\nキャラモーション再生(PID_スタルーク, , EmoShy,,1)\n*\nフェードアウト()
MID_RELIANCE_B_#001	キャラ配置(PID_スタルーク, ME_IN_C,, Surprise, IdleNormal)\nキャラ配置(PID_セアダス, YOU_IN_C,, Relax, IdleNormal)\n\n背景(Map_Event_Hub_Solanel_03_Day)\nライト(CharaLight_Hub_Day)\n\nキャラ視線(PID_スタルーク, PID_セアダス ,PID_セアダス)\nキャラ視線(PID_セアダス, PID_スタルーク, PID_スタルーク)\n\nキャラカメラ(CharaCam_FrontLong2_Right_Mid, PID_スタルーク, cam_anim_track3_r_normal)\nフェードイン()\n\nキャラモーション再生(PID_スタルーク, , EmoProud,,1)\n*\nキャラモーション再生(PID_スタルーク, Smile, IdleNormal)
MID_RELIANCE_B_#002	キャラカメラ(CharaCam_Side_Left2_Mid, PID_セアダス, cam_anim_track_r_normal)\nキャラモーション再生(PID_セアダス, , EmoNod,,1)
MID_RELIANCE_B_#003	
MID_RELIANCE_B_#004	キャラカメラ(CharaCam_FrontLong2_Left_Mid, PID_セアダス, cam_anim_pan_l_normal)\nキャラモーション再生(PID_セアダス, Smile, EmoDeny,,1)\n*\nキャラモーション再生(PID_セアダス, Normal, IdleNormal,,1)
MID_RELIANCE_B_#005	キャラカメラ(CharaCam_FrontLong2_Right_Mid, PID_スタルーク, cam_anim_pan_r_normal)\nキャラモーション再生(PID_スタルーク, , EmoNod,,1)
MID_RELIANCE_B_#006	キャラモーション再生(PID_スタルーク, , EmoDeny2,,1)
MID_RELIANCE_B_#007	キャラカメラ(CharaCam_Side_Right3_Mid, PID_スタルーク, cam_anim_zoom_in_slow)\nキャラモーション再生(PID_スタルーク, , EmoThinkIn,,1)
MID_RELIANCE_B_#008	
MID_RELIANCE_B_#009	キャラカメラ(CharaCam_SideLong_Right2_Mid, PID_スタルーク, cam_anim_pan_u_slow)\nキャラモーション再生(PID_スタルーク, , EmoNod,,1)
MID_RELIANCE_B_#010	キャラモーション再生(PID_スタルーク, , EmoPray,,1)\n*\nキャラモーション再生(PID_スタルーク, Normal, IdleNormal)
MID_RELIANCE_B_#011	キャラカメラ(CharaCam_Side_Left3_Mid, PID_セアダス, cam_anim_zoom_in_slow)\n*\nキャラモーション再生(PID_セアダス, Normal, IdleNormal,,1)
MID_RELIANCE_B_#012	キャラカメラ(CharaCam_FrontLong2_Right_Mid, PID_スタルーク, cam_anim_pan_l_slow)\nキャラモーション再生(PID_スタルーク, , EmoTalk2,,1)
MID_RELIANCE_B_#013	*\nキャラモーション再生(PID_スタルーク, Surprise, IdleNormal)
MID_RELIANCE_B_#014	キャラカメラ(CharaCam_Side_Left2_Mid, PID_セアダス, cam_anim_track_r_normal)
MID_RELIANCE_B_#015	キャラモーション再生(PID_セアダス, , EmoThinkIn,,1)
MID_RELIANCE_B_#016	キャラカメラ(CharaCam_FrontLong2_Left_Mid, PID_セアダス, cam_anim_track3_l_normal)\nキャラモーション再生(PID_セアダス, Sad, EmoThinkOut,,1)
MID_RELIANCE_B_#017	キャラモーション再生(PID_セアダス, Normal, EmoTalk,,1)\n*\nキャラモーション再生(PID_セアダス, Normal, IdleNormal)
MID_RELIANCE_B_#018	キャラカメラ(CharaCam_Side_Right3_Mid, PID_スタルーク, cam_anim_zoom_in_slow)\n*\nキャラモーション再生(PID_スタルーク, Normal, IdleNormal)
MID_RELIANCE_B_#019	キャラカメラ(CharaCam_Side_Left2_Mid, PID_セアダス, cam_anim_track_r_normal)\nキャラモーション再生(PID_セアダス, Die, EmoDeny,,1)\nキャラモーション再生(PID_セアダス, Normal,,4)\n*\nキャラモーション再生(PID_セアダス, Normal, IdleNormal,,1)
MID_RELIANCE_B_#020	キャラカメラ(CharaCam_FrontLong2_Right_Mid, PID_スタルーク, cam_anim_pan_r_normal)\n*\nキャラモーション再生(PID_スタルーク, Sad, IdleNormal,,1)
MID_RELIANCE_B_#021	キャラカメラ(CharaCam_FrontLong2_Left_Mid, PID_セアダス, cam_anim_pan_l_normal)\nキャラモーション再生(PID_セアダス, , EmoTalk,,1)
MID_RELIANCE_B_#022	
MID_RELIANCE_B_#023	キャラカメラ(CharaCam_Side_Left2_Mid, PID_セアダス, cam_anim_track_r_normal)\nキャラモーション再生(PID_セアダス, , EmoPray,,1)
MID_RELIANCE_B_#024	キャラモーション再生(PID_セアダス, Relax, EmoJoy,,1)\n*\nキャラモーション再生(PID_セアダス, Sad, IdleNormal)
MID_RELIANCE_B_#025	キャラカメラ(CharaCam_Side_Right3_Mid, PID_スタルーク, cam_anim_zoom_in_slow)\n*\nキャラモーション再生(PID_スタルーク, Sad, IdleNormal)
MID_RELIANCE_B_#026	キャラカメラ(CharaCam_Side_Left3_Mid, PID_セアダス, cam_anim_zoom_in_slow)\nキャラ視線リセット(PID_スタルーク)\n*\nキャラモーション再生(PID_セアダス, Sad, IdleNormal,,1)
MID_RELIANCE_B_#027	キャラカメラ(CharaCam_FrontLong2_Right_Mid, PID_スタルーク, cam_anim_pan_r_normal)\nキャラモーション再生(PID_スタルーク, , EmoSad,,1)\n*\nキャラモーション再生(PID_スタルーク, Normal, IdleNormal,,1)
MID_RELIANCE_B_#028	キャラカメラ(CharaCam_FrontLong2_Left_Mid, PID_セアダス, cam_anim_pan_l_normal)
MID_RELIANCE_B_#029	キャラモーション再生(PID_セアダス, , EmoTalk,,1)\n*\nフェードアウト()
MID_RELIANCE_A_#001	キャラ配置(PID_スタルーク, ME_IN_C,, Sad, IdleNormal)\nキャラ配置(PID_セアダス, YOU_IN_C,, Normal, IdleNormal)\n\n背景(Map_Event_Hub_Solanel_03_Evening)\nライト(CharaLight_Hub_Evening)\n\nキャラ視線(PID_スタルーク, PID_セアダス, PID_セアダス)\nキャラ視線(PID_セアダス, PID_スタルーク, PID_スタルーク)\n\nキャラカメラ(CharaCam_FrontLong2_Right_Mid, PID_スタルーク, cam_anim_track3_r_normal)\nフェードイン()\n\nキャラモーション再生(PID_スタルーク, , EmoRelax,,1)
MID_RELIANCE_A_#002	キャラモーション再生(PID_スタルーク, , EmoDeny2,,1)\n*\nキャラモーション再生(PID_スタルーク, Normal, IdleNormal,,1)
MID_RELIANCE_A_#003	キャラカメラ(CharaCam_FrontLong2_Left_Mid, PID_セアダス, cam_anim_pan_l_normal)\nキャラモーション再生(PID_セアダス, , EmoDeny2,,1)\n*\nキャラモーション再生(PID_セアダス, , IdleNormal)\nキャラ表示切替(PID_セアダス, False)
MID_RELIANCE_A_#004	キャラカメラ(CharaCam_SideLong_Right2_Mid, PID_スタルーク, cam_anim_track3_r_normal)\nキャラモーション再生(PID_スタルーク, , EmoTalk,,1)
MID_RELIANCE_A_#005	キャラモーション再生(PID_スタルーク, Sad, EmoDeny2,,1)\n*\nキャラモーション再生(PID_スタルーク, Surprise, IdleNormal)\nキャラ表示切替(PID_セアダス, True)
MID_RELIANCE_A_#006	キャラカメラ(CharaCam_Side_Left3_Mid, PID_セアダス, cam_anim_zoom_in_slow)\nキャラモーション再生(PID_セアダス, , EmoThink)
MID_RELIANCE_A_#007	キャラモーション再生(PID_セアダス, Angry, EmoPray,,1)\n*\nキャラモーション再生(PID_セアダス, Normal, IdleNormal)
MID_RELIANCE_A_#008	キャラカメラ(CharaCam_Side_Right3_Mid, PID_スタルーク, cam_anim_zoom_in_slow)
MID_RELIANCE_A_#009	キャラモーション再生(PID_スタルーク, Sad, EmoSad,,1)
MID_RELIANCE_A_#010	*\nキャラモーション再生(PID_スタルーク, Normal, IdleNormal,,1)
MID_RELIANCE_A_#011	キャラカメラ(CharaCam_FrontLong2_Left_Mid, PID_セアダス, cam_anim_pan_l_normal)
MID_RELIANCE_A_#012	キャラモーション再生(PID_セアダス, , EmoTalk2,,1)
MID_RELIANCE_A_#013	
MID_RELIANCE_A_#014	キャラカメラ(CharaCam_SideLong_Left2_Mid, PID_セアダス, cam_anim_pan_u_slow)\nキャラモーション再生(PID_セアダス, Relax, EmoPray,,1)
MID_RELIANCE_A_#015	キャラモーション再生(PID_セアダス, , EmoNod,,1)\n*\nキャラモーション再生(PID_セアダス, Relax, IdleNormal,,1)
MID_RELIANCE_A_#016	キャラカメラ(CharaCam_FrontLong2_Right_Mid, PID_スタルーク, cam_anim_pan_r_normal)\n*\nキャラモーション再生(PID_スタルーク, Smile, IdleNormal,,1)
MID_RELIANCE_A_#017	キャラカメラ(CharaCam_FrontLong2_Left_Mid, PID_セアダス, cam_anim_pan_l_normal)\nキャラモーション再生(PID_セアダス, , EmoTalk2,,1)
MID_RELIANCE_A_#018	キャラカメラ(CharaCam_Side_Right3_Bot, PID_セアダス, cam_anim_zoom_in_slow)\nキャラモーション再生(PID_セアダス, , EmoThinkIn,,1)
MID_RELIANCE_A_#019	キャラカメラ(CharaCam_Side_Left2_Mid, PID_セアダス, cam_anim_track_r_normal)
MID_RELIANCE_A_#020	キャラモーション再生(PID_セアダス, Smile, EmoJoy,,1)\n*\nキャラモーション再生(PID_セアダス, Smile, IdleNormal,,1)
MID_RELIANCE_A_#021	キャラカメラ(CharaCam_FrontLong2_Right_Mid, PID_スタルーク, cam_anim_pan_r_normal)\nキャラモーション再生(PID_スタルーク, , EmoRelax,,1)
MID_RELIANCE_A_#022	キャラカメラ(CharaCam_Side_Right3_Mid, PID_スタルーク, cam_anim_zoom_in_slow)\n*\nキャラモーション再生(PID_スタルーク, Normal, IdleNormal)
MID_RELIANCE_A_#023	キャラカメラ(CharaCam_Side_Left3_Mid, PID_セアダス, cam_anim_zoom_in_slow)\n*\nフェードアウト()
