MID_RELIANCE_C_#001	キャラ配置(PID_アンバー, ME_IN_C, [服装], Normal, IdleNormal, 0)\nキャラ配置(PID_パネトネ, YOU_IN_C, [服装], Normal, IdleNormal, 0)\n\n背景(Map_Event_Hub_Solanel_08_Day)\nライト(CharaLight_Hub_Day, 0, 0, 0)\n\nキャラ視線(PID_パネトネ, PID_アンバー, PID_アンバー)\n\nウェイト(1)\n\nキャラモーション再生(PID_アンバー, Sad)\nキャラモーション再生(PID_アンバー, Sad, EmoSad, 5.5, 0.3)\n\nキャラカメラ(CharaCam_Front_Center_Top, PID_アンバー, cam_anim_pan_u_normal)\n\nフェードイン()
MID_RELIANCE_C_#002	キャラモーション再生(PID_パネトネ, Normal, WalkIn2)\nキャラモーション再生(PID_アンバー, Sad, IdleNormal,, 1)\n\n\nキャラカメラ(CharaCam_Shoulder_Right_Top, PID_アンバー, cam_anim_zoom_in_normal)
MID_RELIANCE_C_#003	キャラモーション再生(PID_アンバー, Normal)\nキャラモーション再生(PID_アンバー, Normal, EmoTalk, 2.5, 0.3)\nキャラモーション再生(PID_パネトネ, Normal, IdleNormal)\n\nキャラカメラ(CharaCam_Side_Left2_Mid, PID_アンバー, cam_anim_track_r_normal)
MID_RELIANCE_C_#004	キャラモーション再生(PID_パネトネ, Normal, EmoThink)\nキャラモーション再生(PID_アンバー, Normal, IdleNormal)\n\nキャラ視線(PID_アンバー, PID_パネトネ, PID_パネトネ)\n\nキャラカメラ(CharaCam_Side_Right2_Mid, PID_パネトネ, cam_anim_track_l_normal)
MID_RELIANCE_C_#005	キャラモーション再生(PID_アンバー, Strike, EmoNod)\nキャラモーション再生(PID_パネトネ, Normal, IdleNormal,, 1)\n\nキャラカメラ(CharaCam_Shoulder_Left_Bot, PID_パネトネ, cam_anim_zoom_in_slow)
MID_RELIANCE_C_#006	キャラモーション再生(PID_アンバー, Strike, IdleNormal,, 1)
MID_RELIANCE_C_#007	キャラモーション再生(PID_アンバー, Sad, EmoSad2,, 0.3)\n\nキャラカメラ(CharaCam_Front_Center2_Mid, PID_アンバー, cam_anim_pan_d_normal)
MID_RELIANCE_C_#008	キャラモーション再生(PID_パネトネ, Smile)\nキャラモーション再生(PID_アンバー, Sad, IdleNormal)\n\nキャラカメラ(CharaCam_Front_Center_Top, PID_パネトネ, cam_anim_pan_u_normal)
MID_RELIANCE_C_#009	キャラモーション再生(PID_アンバー, Sad, EmoThink)\n\nキャラカメラ(CharaCam_Side_Left2_Mid, PID_アンバー, cam_anim_track_r_normal)
MID_RELIANCE_C_#010	キャラモーション再生(PID_パネトネ, Normal, EmoTalk2)\nキャラモーション再生(PID_アンバー, Sad, IdleNormal)\n\nキャラカメラ(CharaCam_Side_Right2_Mid, PID_パネトネ, cam_anim_track_l_normal)
MID_RELIANCE_C_#011	キャラモーション再生(PID_アンバー, Normal)\nキャラモーション再生(PID_パネトネ, Smile, IdleNormal)\n\nキャラカメラ(CharaCam_Side_Left3_Mid, PID_アンバー, cam_anim_pan_d_normal)
MID_RELIANCE_C_#012	キャラモーション再生(PID_パネトネ, Smile)\nキャラモーション再生(PID_パネトネ, Smile, EmoJoy, 1.3, 0.3)\n\nキャラカメラ(CharaCam_Front_Center_Top, PID_パネトネ, cam_anim_zoom_out_normal)
MID_RELIANCE_C_#013	キャラモーション再生(PID_アンバー, Smile)\nキャラモーション再生(PID_アンバー, Smile, EmoTalk2, 2, 0.3)\nキャラモーション再生(PID_パネトネ, Smile, IdleNormal)\n\nキャラカメラ(CharaCam_Front_Center2_Mid, PID_アンバー, cam_anim_pan_d_slow)
MID_RELIANCE_C_#014	キャラモーション再生(PID_アンバー, Sad)
MID_RELIANCE_C_#015	キャラモーション再生(PID_アンバー, Sad, EmoSad,, 1)\n\nキャラカメラ(CharaCam_Shoulder_Left_Bot, PID_パネトネ, cam_anim_zoom_in_normal)
MID_RELIANCE_C_#016	キャラモーション再生(PID_パネトネ, Smile, EmoProud, 0.7, 0.3)\nキャラモーション再生(PID_アンバー, Sad, IdleNormal)\n\nキャラカメラ(CharaCam_Side_Right2_Mid, PID_パネトネ, cam_anim_track_l_normal)
MID_RELIANCE_C_#017	キャラモーション再生(PID_アンバー, Smile)\nキャラモーション再生(PID_アンバー, Smile, EmoTalk, 1.3, 0.3)\nキャラモーション再生(PID_パネトネ, Smile, IdleNormal)\n\nキャラカメラ(CharaCam_Front_Center2_Mid, PID_アンバー, cam_anim_zoom_in_normal)\n\n*\n\nフェードアウト()
MID_RELIANCE_B_#001	キャラ配置(PID_アンバー, ME_IN_C, [服装], Normal, IdleNormal, 0)\nキャラ配置(PID_パネトネ, YOU_IN_C, [服装], Normal, IdleNormal, 0)\nキャラ配置(PID_デモ用_視線設定用, ME_IN_E, [服装], Normal, IdleNormal, 0)\n\nキャラ配置調整(PID_デモ用_視線設定用, 0.5, 0, 0.2, 0)\n\n背景(Map_Event_M015_03)\nライト(CharaLight_M015, 0, 0, 0)\n\nキャラ視線(PID_アンバー, PID_パネトネ, PID_パネトネ)\nキャラ視線(PID_パネトネ, PID_アンバー, PID_アンバー)\n\nキャラモーション再生(PID_アンバー, Smile)\n\nウェイト(1)\n\nキャラカメラ(CharaCam_Shoulder_Left_Bot, PID_パネトネ, cam_anim_track2_l_normal)\n\nフェードイン()
MID_RELIANCE_B_#002	キャラモーション再生(PID_アンバー, Die, EmoThink,, 0.3)\nキャラモーション再生(PID_アンバー, Smile,, 4.5)
MID_RELIANCE_B_#003	キャラモーション再生(PID_パネトネ, Sad, EmoThink)\nキャラモーション再生(PID_アンバー, Smile, IdleNormal)\n\nキャラカメラ(CharaCam_Side_Right3_Mid, PID_パネトネ, cam_anim_pan_d_normal)
MID_RELIANCE_B_#004	キャラモーション再生(PID_アンバー, Normal, EmoTalk, 1.5, 0.3)\nキャラモーション再生(PID_パネトネ, Sad, IdleNormal)\n\nキャラ視線リセット(PID_パネトネ)\n\nキャラカメラ(CharaCam_Side_Left2_Mid, PID_アンバー, cam_anim_track_r_slow)
MID_RELIANCE_B_#005	キャラモーション再生(PID_パネトネ, Smile, EmoLook)\nキャラモーション再生(PID_アンバー, Normal, IdleNormal)\n\nキャラカメラ(CharaCam_Side_Right2_Top, PID_パネトネ, cam_anim_track_l_normal)
MID_RELIANCE_B_#006	キャラモーション再生(PID_アンバー, Relax)\nキャラモーション再生(PID_パネトネ, Smile, IdleNormal)\n\nキャラカメラ(CharaCam_Front_Center_Top, PID_アンバー, cam_anim_pan_u_slow)
MID_RELIANCE_B_#007	キャラモーション再生(PID_アンバー, Strike, EmoSurprise2, 1)\nキャラ視線(PID_パネトネ, PID_アンバー, PID_アンバー)\n\nキャラカメラ(CharaCam_Shoulder_Left_Bot, PID_パネトネ, cam_anim_zoom_out_fast, 1)\n\n*\n\nパペット会話中断()\n\nウェイト(1)
MID_RELIANCE_B_#008	キャラモーション再生(PID_パネトネ, Normal)
MID_RELIANCE_B_#009	キャラモーション再生(PID_アンバー, Strike, IdleNormal)\n\nキャラカメラ(CharaCam_Front_Center_Top, PID_パネトネ, cam_anim_pan_u_normal)
MID_RELIANCE_B_#010	キャラモーション再生(PID_アンバー, Sad)\n\nキャラカメラ(CharaCam_Front_Center_Mid, PID_アンバー, cam_anim_zoom_out_slow)
MID_RELIANCE_B_#011	キャラモーション再生(PID_アンバー, Sad, EmoSad,, 0.3)
MID_RELIANCE_B_#012	
MID_RELIANCE_B_#013	キャラモーション再生(PID_アンバー, Sad, IdleNormal,, 1)\n\nキャラカメラ(CharaCam_Shoulder_Left_Bot, PID_パネトネ, cam_anim_track2_l_normal)
MID_RELIANCE_B_#014	キャラモーション再生(PID_パネトネ, Surprise)\nキャラモーション再生(PID_アンバー, Sad, IdleNormal)\n\nキャラ視線(PID_パネトネ, PID_デモ用_視線設定用, PID_デモ用_視線設定用)\n\nキャラカメラ(CharaCam_Side_Right2_Mid, PID_パネトネ, cam_anim_zoom_in_normal)
MID_RELIANCE_B_#015	キャラモーション再生(PID_アンバー, Normal)\n\nキャラカメラ(CharaCam_Side_Left3_Mid, PID_アンバー, cam_anim_pan_d_normal)
MID_RELIANCE_B_#016	キャラモーション再生(PID_パネトネ, Surprise, TurnL)\n\nキャラ回転(PID_パネトネ, 300, 1.7)\n\nキャラカメラ(CharaCam_Front_Center_Top, PID_パネトネ, cam_anim_zoom_out_normal)
MID_RELIANCE_B_#017	キャラモーション再生(PID_アンバー, Die, EmoNod)\nキャラモーション再生(PID_アンバー, Normal, IdleNormal, 2.5, 1)\nキャラモーション再生(PID_パネトネ, Surprise, IdleNormal)\n\nキャラカメラ(CharaCam_Front_Center_Top, PID_アンバー, cam_anim_pan_u_normal)
MID_RELIANCE_B_#018	キャラモーション再生(PID_アンバー, Normal, IdleNormal)\nキャラモーション再生(PID_パネトネ, Smile, EmoDeny2)\n\nキャラカメラ(CharaCam_Side_Right2_Mid, PID_パネトネ, cam_anim_zoom_in_normal)
MID_RELIANCE_B_#019	キャラモーション再生(PID_パネトネ, Smile, IdleNormal)\n\nキャラカメラ(CharaCam_Side_Left2_Mid, PID_アンバー, cam_anim_track_r_normal)
MID_RELIANCE_B_#020	キャラモーション再生(PID_パネトネ, Smile, EmoTalk2)\n\nキャラ視線(PID_パネトネ, PID_アンバー, PID_アンバー)\n\nキャラカメラ(CharaCam_Shoulder_Right_Top, PID_アンバー, cam_anim_track2_r_normal)
MID_RELIANCE_B_#021	キャラモーション再生(PID_アンバー, Sad)\nキャラモーション再生(PID_パネトネ, Smile, IdleNormal)\n\nキャラ視線(PID_アンバー, PID_デモ用_視線設定用, PID_デモ用_視線設定用)\n\nキャラカメラ(CharaCam_Side_Left2_Mid, PID_アンバー, cam_anim_zoom_in_slow)
MID_RELIANCE_B_#022	キャラモーション再生(PID_アンバー, Surprise)
MID_RELIANCE_B_#023	\n*\n\nパペット会話中断()
MID_RELIANCE_B_#024	フェードアウト()\n\n一枚絵表示(Tex_Event_Effect_Black)\n\nウェイト(1)\n\nフェードイン()\n\n*\n\nフェードアウト()
MID_RELIANCE_A_#001	キャラ配置(PID_アンバー, ME_IN_C, [服装], Normal, IdleNormal, 0)\nキャラ配置(PID_パネトネ, YOU_IN_C, [服装], Normal, IdleNormal, 0)\n\n背景(Map_Event_Hub_Solanel_01_Day)\nライト(CharaLight_Hub_Day, 0, 0, 0)\n\nキャラ視線(PID_アンバー, PID_パネトネ, PID_パネトネ)\nキャラ視線(PID_パネトネ, PID_アンバー, PID_アンバー)\n\nウェイト(1)\n\nキャラモーション再生(PID_アンバー, Sad)\n\nキャラカメラ(CharaCam_Shoulder_Left_Bot, PID_パネトネ, cam_anim_zoom_in_slow)\n\nフェードイン()
MID_RELIANCE_A_#002	キャラモーション再生(PID_アンバー, Die, EmoSad, 2.1, 0.3)
MID_RELIANCE_A_#003	キャラモーション再生(PID_パネトネ, Sad)\nキャラモーション再生(PID_アンバー, Die, IdleNormal)\n\nキャラカメラ(CharaCam_Side_Right2_Mid, PID_パネトネ, cam_anim_track_l_slow)
MID_RELIANCE_A_#004	キャラモーション再生(PID_パネトネ, Sad, EmoSad,, 0.3)
MID_RELIANCE_A_#005	キャラモーション再生(PID_アンバー, Sad)\nキャラモーション再生(PID_パネトネ, Sad, IdleNormal)\n\nキャラカメラ(CharaCam_Side_Left2_Mid, PID_アンバー, cam_anim_track_r_slow)
MID_RELIANCE_A_#006	キャラモーション再生(PID_アンバー, Sad, EmoTalk, 1.7, 0.3)
MID_RELIANCE_A_#007	キャラモーション再生(PID_アンバー, Strike, IdleNormal)\n\nキャラカメラ(CharaCam_Front_Center_Top, PID_パネトネ, cam_anim_pan_u_slow)
MID_RELIANCE_A_#008	キャラモーション再生(PID_パネトネ, Smile, EmoThink,, 0.3)
MID_RELIANCE_A_#009	キャラモーション再生(PID_アンバー, Angry)\nキャラモーション再生(PID_パネトネ, Smile, IdleNormal)\n\nキャラカメラ(CharaCam_Front_Center2_Mid, PID_アンバー, cam_anim_pan_d_slow)
MID_RELIANCE_A_#010	キャラモーション再生(PID_アンバー, Sad)
MID_RELIANCE_A_#011	キャラモーション再生(PID_パネトネ, Smile, EmoDeny2)\n\nキャラカメラ(CharaCam_Side_Right2_Mid, PID_パネトネ, cam_anim_track_l_normal)
MID_RELIANCE_A_#012	キャラモーション再生(PID_パネトネ, Smile, IdleNormal)\n\nキャラカメラ(CharaCam_Side_Left2_Mid, PID_アンバー, cam_anim_track_r_normal)
MID_RELIANCE_A_#013	キャラモーション再生(PID_パネトネ, Normal, EmoSad2)\n\nキャラカメラ(CharaCam_Shoulder_Right_Top, PID_アンバー, cam_anim_zoom_in_slow)
MID_RELIANCE_A_#014	
MID_RELIANCE_A_#015	キャラカメラ(CharaCam_Front_Center_Top, PID_パネトネ, cam_anim_zoom_out_slow)
MID_RELIANCE_A_#016	キャラモーション再生(PID_パネトネ, Smile, EmoJoy,, 1)
MID_RELIANCE_A_#017	キャラモーション再生(PID_アンバー, Sad, EmoSad2)\nキャラモーション再生(PID_パネトネ, Smile, IdleNormal)\n\nキャラカメラ(CharaCam_Front_Center2_Mid, PID_アンバー, cam_anim_zoom_in_normal)
MID_RELIANCE_A_#018	キャラモーション再生(PID_アンバー, Sad, IdleNormal)\n\nキャラカメラ(CharaCam_Side_Right3_Mid, PID_パネトネ, cam_anim_pan_d_normal)
MID_RELIANCE_A_#019	キャラモーション再生(PID_アンバー, Relax, EmoNod)\n\nキャラカメラ(CharaCam_Shoulder_Left_Bot, PID_パネトネ, cam_anim_zoom_in_slow)
MID_RELIANCE_A_#020	
MID_RELIANCE_A_#021	キャラカメラ(CharaCam_Side_Left3_Mid, PID_アンバー, cam_anim_pan_d_slow)
MID_RELIANCE_A_#022	キャラモーション再生(PID_アンバー, Smile, EmoTalk,, 0.3)
MID_RELIANCE_A_#023	キャラモーション再生(PID_パネトネ, Smile, EmoTalk)\nキャラモーション再生(PID_アンバー, Relax, IdleNormal)\n\nキャラカメラ(CharaCam_Side_Right2_Top, PID_パネトネ, cam_anim_zoom_in_normal)
MID_RELIANCE_A_#024	キャラモーション再生(PID_アンバー, Smile)\nキャラモーション再生(PID_パネトネ, Smile, IdleNormal)\n\nキャラカメラ(CharaCam_Side_Left2_Mid, PID_アンバー, cam_anim_track_r_normal)
MID_RELIANCE_A_#025	キャラモーション再生(PID_パネトネ, Normal)\nキャラモーション再生(PID_パネトネ, Normal, EmoTalk2, 1.8, 0.3)\n\nキャラカメラ(CharaCam_Front_Center_Top, PID_パネトネ, cam_anim_pan_u_normal)
MID_RELIANCE_A_#026	キャラモーション再生(PID_アンバー, Sad)\nキャラモーション再生(PID_パネトネ, Normal, IdleNormal)\n\nキャラカメラ(CharaCam_Side_Left2_Mid, PID_アンバー, cam_anim_track_r_normal)
MID_RELIANCE_A_#027	キャラモーション再生(PID_パネトネ, Normal, EmoThink, 3, 0.3)\n\nキャラカメラ(CharaCam_Side_Right2_Mid, PID_パネトネ, cam_anim_track_l_normal)
MID_RELIANCE_A_#028	キャラモーション再生(PID_アンバー, Normal, EmoNod)\nキャラモーション再生(PID_パネトネ, Normal, IdleNormal)\n\nキャラカメラ(CharaCam_Side_Left3_Mid, PID_アンバー, cam_anim_pan_d_slow)
MID_RELIANCE_A_#029	キャラモーション再生(PID_アンバー, Smile, EmoTalk2, 2.5, 1)
MID_RELIANCE_A_#030	キャラモーション再生(PID_アンバー, Smile, IdleNormal)\nキャラモーション再生(PID_パネトネ, Smile, EmoJoy)\n\nキャラカメラ(CharaCam_Front_Center2_Mid, PID_パネトネ, cam_anim_zoom_in_normal)\n\n*\n\nフェードアウト()
