MID_RELIANCE_C_#001	キャラ配置(PID_アンバー, ME_IN_C, [服装], Normal, IdleNormal, 0)\nキャラ配置(PID_メリン, YOU_IN_C, [服装], Normal, IdleNormal, 0)\n\nキャラアニメーター切替(PID_アンバー, Unit/Anim/Hub/AOC_Hub_Hum2M)\n\n背景(Map_Event_Hub_Solanel_08_Day)\nライト(CharaLight_Hub_Day, 0, 0, 0)\n\nキャラ視線(PID_アンバー, PID_メリン, PID_メリン)\nキャラ視線(PID_メリン, PID_アンバー, PID_アンバー)\n\nキャラモーション再生(PID_アンバー, Normal, IdleNormal)\n\nウェイト(1)\n\nキャラモーション再生(PID_メリン, Normal, EmoThink,, 1)\n\nキャラカメラ(CharaCam_Shoulder_Right_Top, PID_アンバー, cam_anim_track_r_normal)\n\nフェードイン()
MID_RELIANCE_C_#002	キャラモーション再生(PID_アンバー, Normal, EmoThink,, 0.3)\nキャラモーション再生(PID_メリン, Normal, IdleNormal)\n\nキャラカメラ(CharaCam_Side_Left2_Mid, PID_アンバー, cam_anim_track_r_normal)
MID_RELIANCE_C_#003	キャラモーション再生(PID_メリン, Normal, EmoTalk,, 0.3)\nキャラモーション再生(PID_アンバー, Normal, IdleNormal)\n\nキャラカメラ(CharaCam_Side_Right2_Mid, PID_メリン, cam_anim_track_l_slow)
MID_RELIANCE_C_#004	
MID_RELIANCE_C_#005	キャラモーション再生(PID_アンバー, Normal, EmoNod)\nキャラモーション再生(PID_メリン, Normal, IdleNormal,, 1)\n\nキャラカメラ(CharaCam_Shoulder_Left_Mid, PID_メリン, cam_anim_track2_l_normal)
MID_RELIANCE_C_#006	
MID_RELIANCE_C_#007	キャラモーション再生(PID_アンバー, Normal, EmoTalk,, 1)\n\nキャラカメラ(CharaCam_Front_Center_Top, PID_アンバー, cam_anim_pan_u_normal)
MID_RELIANCE_C_#008	キャラモーション再生(PID_メリン, Normal, EmoNod,, 0.3)\nキャラモーション再生(PID_アンバー, Normal, IdleNormal)\n\nキャラカメラ(CharaCam_Side_Right2_Top, PID_メリン, cam_anim_track_l_normal)
MID_RELIANCE_C_#009	キャラモーション再生(PID_メリン, Normal, IdleNormal)\n\nキャラカメラ(CharaCam_Side_Left2_Mid, PID_アンバー, cam_anim_track_r_normal)
MID_RELIANCE_C_#010	キャラモーション再生(PID_メリン, Surprise)\n\nキャラカメラ(CharaCam_Front_Center_Top, PID_メリン, cam_anim_pan_u_slow)
MID_RELIANCE_C_#011	キャラモーション再生(PID_メリン, Smile, EmoJoy,, 1)
MID_RELIANCE_C_#012	キャラカメラ(CharaCam_Shoulder_Right_Top, PID_アンバー, cam_anim_track2_r_normal)
MID_RELIANCE_C_#013	キャラモーション再生(PID_アンバー, Smile, EmoTalk2,, 0.3)\nキャラモーション再生(PID_メリン, Smile, IdleNormal)\n\nキャラカメラ(CharaCam_Side_Left2_Mid, PID_アンバー, cam_anim_track_r_slow)
MID_RELIANCE_C_#014	
MID_RELIANCE_C_#015	キャラモーション再生(PID_メリン, Shy, EmoSad,, 0.3)\nキャラモーション再生(PID_アンバー, Smile, IdleNormal)\n\nキャラカメラ(CharaCam_Side_Right2_Top, PID_メリン, cam_anim_track_l_normal)
MID_RELIANCE_C_#016	キャラモーション再生(PID_アンバー, Sad, EmoDeny)\nキャラモーション再生(PID_メリン, Shy, IdleNormal)\n\nキャラカメラ(CharaCam_Front_Center_Top, PID_アンバー, cam_anim_pan_u_normal)
MID_RELIANCE_C_#017	キャラモーション再生(PID_アンバー, Smile, IdleNormal,, 1)
MID_RELIANCE_C_#018	キャラモーション再生(PID_アンバー, Smile, Posing,, 0.3)\n\nキャラカメラ(CharaCam_FrontLong2_Left_Bot, PID_アンバー, cam_anim_pan_l_normal)\n\n一枚絵表示(Tex_Event_Effect_Black)
MID_RELIANCE_C_#019	キャラモーション再生(PID_アンバー, Surprise, IdleNormal, 1)\n\n*\n\nパペット会話中断()\n\nウェイト(2)\n\n一枚絵非表示()
MID_RELIANCE_C_#020	キャラモーション再生(PID_アンバー, Sad, EmoSad)\n\nキャラカメラ(CharaCam_Shoulder_Left_Mid, PID_メリン, cam_anim_track2_l_normal)
MID_RELIANCE_C_#021	キャラモーション再生(PID_メリン, Surprise)\nキャラモーション再生(PID_アンバー, Sad, IdleNormal)\n\nキャラカメラ(CharaCam_Side_Right2_Top, PID_メリン, cam_anim_track_l_slow)
MID_RELIANCE_C_#022	キャラモーション再生(PID_メリン, Smile, EmoNod,, 0.3)
MID_RELIANCE_C_#023	キャラモーション再生(PID_アンバー, Surprise)\nキャラモーション再生(PID_メリン, Smile, IdleNormal)\n\nキャラカメラ(CharaCam_Side_Left2_Mid, PID_アンバー, cam_anim_track_r_normal)
MID_RELIANCE_C_#024	キャラカメラ(CharaCam_Side_Right3_Mid, PID_メリン, cam_anim_pan_d_normal)
MID_RELIANCE_C_#025	キャラモーション再生(PID_メリン, Smile, EmoRelax,, 1)
MID_RELIANCE_C_#026	キャラモーション再生(PID_アンバー, Sad)\nキャラモーション再生(PID_メリン, Smile, IdleNormal)\n\nキャラカメラ(CharaCam_Front_Center_Top, PID_アンバー, cam_anim_pan_u_normal)\n\n*\n\nフェードアウト()
MID_RELIANCE_B_#001	キャラ配置(PID_アンバー, ME_IN_C, [服装], Normal, IdleNormal, 0)\nキャラ配置(PID_メリン, YOU_IN_C, [服装], Normal, IdleNormal, 0)\n\n背景(Map_Event_Hub_Solanel_01_Day)\nライト(CharaLight_Hub_Day, 0, 0, 0)\n\nキャラ視線(PID_アンバー, PID_メリン, PID_メリン)\nキャラ視線(PID_メリン, PID_アンバー, PID_アンバー)\n\nウェイト(1)\n\nキャラモーション再生(PID_メリン, Normal, EmoTalk,, 1)\n\nキャラカメラ(CharaCam_Shoulder_Right_Top, PID_アンバー, cam_anim_track_r_normal)\n\nフェードイン()
MID_RELIANCE_B_#002	キャラモーション再生(PID_メリン, Normal, IdleNormal)\n\nキャラカメラ(CharaCam_Side_Left2_Mid, PID_アンバー, cam_anim_track_r_normal)
MID_RELIANCE_B_#003	キャラモーション再生(PID_メリン, Normal, EmoThink,, 0.3)\n\nキャラカメラ(CharaCam_Side_Right2_Mid, PID_メリン, cam_anim_track_l_normal)
MID_RELIANCE_B_#004	キャラモーション再生(PID_アンバー, Smile, EmoNod)\nキャラモーション再生(PID_メリン, Normal, IdleNormal)\n\nキャラカメラ(CharaCam_Side_Left3_Mid, PID_アンバー, cam_anim_pan_d_normal)
MID_RELIANCE_B_#005	キャラモーション再生(PID_メリン, Smile)\nキャラモーション再生(PID_アンバー, Smile, IdleNormal)\n\nキャラカメラ(CharaCam_Front_Center_Top, PID_メリン, cam_anim_pan_u_normal)
MID_RELIANCE_B_#006	キャラモーション再生(PID_メリン, Smile, EmoJoy,, 1)\n\nキャラカメラ(CharaCam_Shoulder_Right_Top, PID_アンバー, cam_anim_track_r_slow)
MID_RELIANCE_B_#007	
MID_RELIANCE_B_#008	キャラモーション再生(PID_アンバー, Normal, EmoTalk,, 0.3)\nキャラモーション再生(PID_メリン, Smile, IdleNormal)\n\nキャラカメラ(CharaCam_Side_Left2_Mid, PID_アンバー, cam_anim_track_r_normal)
MID_RELIANCE_B_#009	キャラモーション再生(PID_アンバー, Normal, IdleNormal)\n\nキャラカメラ(CharaCam_Side_Right2_Mid, PID_メリン, cam_anim_track_l_normal)
MID_RELIANCE_B_#010	キャラモーション再生(PID_アンバー, Smile, EmoThink)\n\nキャラカメラ(CharaCam_Shoulder_Left_Mid, PID_メリン, cam_anim_track2_l_normal)
MID_RELIANCE_B_#011	キャラモーション再生(PID_メリン, Smile, EmoTalk,, 0.3)\nキャラモーション再生(PID_アンバー, Smile, IdleNormal)\n\nキャラカメラ(CharaCam_Side_Right3_Mid, PID_メリン, cam_anim_pan_d_normal)
MID_RELIANCE_B_#012	キャラモーション再生(PID_アンバー, Smile, EmoNod)\nキャラモーション再生(PID_メリン, Smile, IdleNormal)\n\nキャラカメラ(CharaCam_Front_Center_Top, PID_アンバー, cam_anim_pan_u_normal)
MID_RELIANCE_B_#013	キャラモーション再生(PID_メリン, Smile, EmoRelax,, 1)\nキャラモーション再生(PID_アンバー, Smile, IdleNormal)\n\nキャラカメラ(CharaCam_Front_Center2_Mid, PID_メリン, cam_anim_pan_d_normal)\n\n*\n\nパペット会話中断()\n\nフェードアウト()\n\n背景(Map_Event_Hub_Solanel_07_Day)\nライト(CharaLight_Hub_Day, 0, 0, 0)\n\nキャラモーション再生(PID_メリン, Smile, IdleNormal)\n\nウェイト(2)
MID_RELIANCE_B_#014	
MID_RELIANCE_B_#015	キャラモーション再生(PID_アンバー, Sad, EmoTired)\nキャラモーション再生(PID_メリン, Surprise)\n\nキャラカメラ(CharaCam_FrontLong2_Left_Bot, PID_アンバー, cam_anim_pan_l_normal)\n\nフェードイン()
MID_RELIANCE_B_#016	キャラモーション再生(PID_アンバー, Sad, IdleNormal)\n\nキャラカメラ(CharaCam_Front_Center_Top, PID_メリン, cam_anim_pan_u_normal)
MID_RELIANCE_B_#017	キャラモーション再生(PID_アンバー, Sad, EmoSad,, 0.3)\n\nキャラカメラ(CharaCam_Side_Left2_Mid, PID_アンバー, cam_anim_track_r_normal)
MID_RELIANCE_B_#018	キャラモーション再生(PID_メリン, Sad, EmoTalk,, 0.3)\nキャラモーション再生(PID_アンバー, Sad, IdleNormal)\n\nキャラカメラ(CharaCam_Side_Right2_Mid, PID_メリン, cam_anim_track_l_normal)
MID_RELIANCE_B_#019	キャラモーション再生(PID_メリン, Sad, IdleNormal)\n\nキャラカメラ(CharaCam_Front_Center_Top, PID_アンバー, cam_anim_pan_u_slow)
MID_RELIANCE_B_#020	キャラモーション再生(PID_アンバー, Sad)
MID_RELIANCE_B_#021	キャラカメラ(CharaCam_Front_Center2_Mid, PID_メリン, cam_anim_pan_d_normal)\n\n*\n\nフェードアウト()
MID_RELIANCE_A_#001	キャラ配置(PID_アンバー, YOU_IN_C, [服装], Normal, IdleNormal, 0)\nキャラ配置(PID_メリン, ME_IN_C, [服装], Normal, IdleNormal, 0)\n\n背景(Map_Event_Hub_Solanel_01_Day)\nライト(CharaLight_Hub_Day, 0, 0, 0)\n\nキャラ視線(PID_アンバー, PID_メリン, PID_メリン)\nキャラ視線(PID_メリン, PID_アンバー, PID_アンバー)\n\nウェイト(1)\n\nキャラモーション再生(PID_アンバー, Sad)\n\nキャラカメラ(CharaCam_Shoulder_Left_Mid, PID_メリン, cam_anim_track2_l_normal)\n\nフェードイン()
MID_RELIANCE_A_#002	キャラモーション再生(PID_メリン, Surprise)\n\nキャラカメラ(CharaCam_Front_Center_Top, PID_メリン, cam_anim_pan_u_normal)
MID_RELIANCE_A_#003	キャラモーション再生(PID_アンバー, Sad, EmoTalk,, 0.3)\n\nキャラカメラ(CharaCam_Side_Left2_Mid, PID_アンバー, cam_anim_track_r_normal)
MID_RELIANCE_A_#004	キャラモーション再生(PID_メリン, Normal)\nキャラモーション再生(PID_アンバー, Sad, IdleNormal)\n\nキャラカメラ(CharaCam_Side_Right2_Mid, PID_メリン, cam_anim_track_l_normal)
MID_RELIANCE_A_#005	キャラモーション再生(PID_アンバー, Sad, EmoDeny2)\n\nキャラカメラ(CharaCam_Shoulder_Left_Mid, PID_メリン, cam_anim_track2_l_normal)
MID_RELIANCE_A_#006	
MID_RELIANCE_A_#007	キャラモーション再生(PID_アンバー, Sad, EmoThink,, 1)\n\nキャラカメラ(CharaCam_Front_Center2_Mid, PID_アンバー, cam_anim_pan_d_normal)
MID_RELIANCE_A_#008	キャラモーション再生(PID_メリン, Normal, EmoDeny2,, 0.3)\nキャラモーション再生(PID_アンバー, Sad, IdleNormal)\n\nキャラカメラ(CharaCam_Front_Center_Top, PID_メリン, cam_anim_pan_u_slow)
MID_RELIANCE_A_#009	
MID_RELIANCE_A_#010	
MID_RELIANCE_A_#011	キャラモーション再生(PID_メリン, Smile)\nキャラモーション再生(PID_メリン, Smile, EmoTalk2, 1.5, 1)\n\nキャラカメラ(CharaCam_Shoulder_Right_Mid, PID_アンバー, cam_anim_zoom_in_normal)
MID_RELIANCE_A_#012	キャラモーション再生(PID_アンバー, Shy)\nキャラモーション再生(PID_メリン, Smile, IdleNormal)\n\nキャラカメラ(CharaCam_Side_Left3_Mid, PID_アンバー, cam_anim_pan_d_slow)
MID_RELIANCE_A_#013	キャラモーション再生(PID_アンバー, Smile, EmoTalk, 3, 0.3)
MID_RELIANCE_A_#014	キャラモーション再生(PID_メリン, Smile, EmoNod,, 0.3)\nキャラモーション再生(PID_アンバー, Smile, IdleNormal)\n\nキャラカメラ(CharaCam_Side_Right2_Mid, PID_メリン, cam_anim_track_l_normal)
MID_RELIANCE_A_#015	キャラモーション再生(PID_アンバー, Smile, EmoProud)\nキャラモーション再生(PID_メリン, Smile, IdleNormal)\n\nキャラカメラ(CharaCam_Front_Center_Top, PID_アンバー, cam_anim_zoom_out_slow)
MID_RELIANCE_A_#016	
MID_RELIANCE_A_#017	キャラモーション再生(PID_メリン, Normal, EmoThink,, 0.3)\nキャラモーション再生(PID_アンバー, Smile, IdleNormal)\n\nキャラカメラ(CharaCam_Front_Center2_Mid, PID_メリン, cam_anim_pan_d_slow)
MID_RELIANCE_A_#018	キャラモーション再生(PID_メリン, Smile)\n\n*\n\nフェードアウト()
