MID_RELIANCE_C_#001	キャラ配置(PID_ヴァンドレ, ME_IN_C, [服装], Normal, IdleNormal, 0)\nキャラ配置(PID_リンデン, YOU_IN_C, [服装], Normal, IdleNormal, 0)\n\n背景(Map_Event_Hub_Solanel_18_Day)\nライト(CharaLight_Hub_Day)\n\nキャラ視線(PID_ヴァンドレ, PID_リンデン, PID_リンデン)\nキャラ視線(PID_リンデン, PID_ヴァンドレ, PID_ヴァンドレ)\n\nキャラモーション再生(PID_リンデン, Pain, EmoTired)\nウェイト(1.0)\nキャラモーション再生(PID_ヴァンドレ, Normal, WalkIn2)\n\nキャラカメラ(CharaCam_FrontLong2_Right_Mid, PID_リンデン, cam_anim_track_l_slow)\nフェードイン()
MID_RELIANCE_C_#002	キャラカメラ(CharaCam_FrontLong2_Left_Mid, PID_ヴァンドレ, cam_anim_track_r_slow)\nキャラモーション再生(PID_ヴァンドレ, Normal, IdleNormal)
MID_RELIANCE_C_#003	キャラカメラ(CharaCam_Side_Right2_Mid, PID_リンデン, cam_anim_track_l_slow)\nキャラモーション再生(PID_リンデン, Pain, EmoDeny2)
MID_RELIANCE_C_#004	
MID_RELIANCE_C_#005	キャラカメラ(CharaCam_Side_Left2_Mid, PID_ヴァンドレ, cam_anim_track_r_slow)
MID_RELIANCE_C_#006	キャラカメラ(CharaCam_FrontLong2_Right_Top, PID_リンデン, cam_anim_track_l_slow)\nキャラモーション再生(PID_リンデン, Sad, EmoDeny)
MID_RELIANCE_C_#007	
MID_RELIANCE_C_#008	キャラカメラ(CharaCam_FrontLong2_Left_Mid, PID_ヴァンドレ, cam_anim_track_r_slow)
MID_RELIANCE_C_#009	キャラカメラ(CharaCam_Front_Center_Top, PID_ヴァンドレ, cam_anim_zoom_out_slow)\nキャラモーション再生(PID_ヴァンドレ, Die, EmoThinkIn)
MID_RELIANCE_C_#010	キャラモーション再生(PID_ヴァンドレ, Normal)
MID_RELIANCE_C_#011	キャラモーション再生(PID_ヴァンドレ, Normal, EmoThinkOut,, 0.5)\nキャラカメラ(CharaCam_FrontLong2_Left_Mid, PID_ヴァンドレ, cam_anim_track_r_slow)
MID_RELIANCE_C_#012	キャラカメラ(CharaCam_Side_Right2_Top, PID_リンデン, cam_anim_track_l_slow)\nキャラモーション再生(PID_リンデン, Smile, EmoNod)
MID_RELIANCE_C_#013	キャラモーション再生(PID_リンデン, Smile, EmoJoy,, 0.5)
MID_RELIANCE_C_#014	キャラカメラ(CharaCam_Side_Left2_Top, PID_ヴァンドレ, cam_anim_track_r_slow)\nキャラモーション再生(PID_ヴァンドレ, Normal, EmoNod)
MID_RELIANCE_C_#015	キャラカメラ(CharaCam_Side_Right2_Mid, PID_リンデン, cam_anim_track_l_slow)\nキャラモーション再生(PID_リンデン, Normal, EmoDeny2)
MID_RELIANCE_C_#016	キャラカメラ(CharaCam_FrontLong2_Right_Top, PID_リンデン, cam_anim_zoom_out_slow)\nキャラモーション再生(PID_リンデン, Smile, EmoJoy)\n*\nフェードアウト()
MID_RELIANCE_B_#001	キャラ配置(PID_ヴァンドレ, ME_IN_C, [服装], Normal, IdleNormal, 0)\nキャラ配置(PID_リンデン, YOU_IN_C, [服装], Normal, IdleNormal, 0)\n\n背景(Map_Event_Hub_Solanel_01_Day)\nライト(CharaLight_Hub_Day)\n\nキャラ視線(PID_ヴァンドレ, PID_リンデン, PID_リンデン)\n\nキャラ配置調整(PID_リンデン, 0, 0, 0, 110)\n\nキャラカメラ(CharaCam_FrontLong2_Right_Mid, PID_リンデン, cam_anim_track_l_slow)\nキャラモーション再生(PID_リンデン, Normal, EmoThinkLoop)\nウェイト(1)\nフェードイン()
MID_RELIANCE_B_#002	キャラカメラ(CharaCam_FrontLong2_Left_Mid, PID_ヴァンドレ, cam_anim_track_r_slow)\nキャラモーション再生(PID_ヴァンドレ, Normal, EmoTalk,, 1)\nキャラモーション再生(PID_リンデン, Normal, EmoThinkOut,, 0.5)
MID_RELIANCE_B_#003	キャラカメラ(CharaCam_Side_Right2_Mid, PID_リンデン, cam_anim_track_l_slow)\nキャラ視線(PID_リンデン, PID_ヴァンドレ, PID_ヴァンドレ)\nキャラモーション再生(PID_リンデン, Normal, TurnL)\nキャラ回転(PID_リンデン, -110, 1.7)
MID_RELIANCE_B_#004	キャラモーション再生(PID_リンデン, Normal, EmoThinkIn,, 0.5)\n
MID_RELIANCE_B_#005	キャラカメラ(CharaCam_Side_Left2_Mid, PID_ヴァンドレ, cam_anim_track_r_slow)\nキャラモーション再生(PID_ヴァンドレ, Normal, EmoTalk2,, 1)\n
MID_RELIANCE_B_#006	キャラカメラ(CharaCam_Front_Center_Top, PID_リンデン, cam_anim_zoom_in_slow)\nキャラモーション再生(PID_リンデン, Smile, 2)
MID_RELIANCE_B_#007	キャラカメラ(CharaCam_Front_Center_Top, PID_ヴァンドレ, cam_anim_zoom_in_slow)\nキャラモーション再生(PID_ヴァンドレ, Surprise, IdlreNormal,, 0.5)\n\nキャラモーション再生(PID_リンデン, Normal, EmoThinkOut)
MID_RELIANCE_B_#008	キャラカメラ(CharaCam_FrontLong2_Right_Mid, PID_リンデン, cam_anim_track_l_slow)\nキャラモーション再生(PID_リンデン, Normal, EmoDeny2,, 0.5)\nキャラモーション再生(PID_ヴァンドレ, Normal, IdleNormal,, 1)
MID_RELIANCE_B_#009	
MID_RELIANCE_B_#010	キャラカメラ(CharaCam_Front_Center_Mid, PID_リンデン, cam_anim_zoom_out_slow)\nキャラモーション再生(PID_リンデン, Smile, EmoTalk,, 0.5)
MID_RELIANCE_B_#011	
MID_RELIANCE_B_#012	キャラカメラ(CharaCam_Side_Right2_Mid, PID_リンデン, cam_anim_track_l_slow)\nキャラモーション再生(PID_リンデン, Smile, EmoTalk2,, 0.5)
MID_RELIANCE_B_#013	キャラカメラ(CharaCam_Side_Left2_Mid, PID_ヴァンドレ, cam_anim_track_r_slow)
MID_RELIANCE_B_#014	キャラモーション再生(PID_ヴァンドレ, Normal, EmoDeny2,, 0.5)
MID_RELIANCE_B_#015	キャラカメラ(CharaCam_FrontLong2_Right_Mid, PID_リンデン, cam_anim_track_l_slow)\nキャラモーション再生(PID_リンデン, Surprise, EmoTalk,, 0.5)
MID_RELIANCE_B_#016	キャラカメラ(CharaCam_FrontLong2_Left_Mid, PID_ヴァンドレ, cam_anim_track_r_slow)\nキャラモーション再生(PID_ヴァンドレ, Normal, EmoTalk,, 1)
MID_RELIANCE_B_#017	
MID_RELIANCE_B_#018	キャラカメラ(CharaCam_Side_Right2_Top, PID_リンデン, cam_anim_track_l_slow)\nキャラモーション再生(PID_リンデン, Normal, EmoThinkIn,, 0.5)
MID_RELIANCE_B_#019	
MID_RELIANCE_B_#020	キャラカメラ(CharaCam_FrontLong2_Right_Mid, PID_リンデン, cam_anim_track_l_slow)\nキャラモーション再生(PID_リンデン, Normal, EmoThinkOut,, 0.5)
MID_RELIANCE_B_#021	キャラモーション再生(PID_リンデン, Smile, EmoNod,, 0.5)\n*\nフェードアウト()
MID_RELIANCE_A_#001	キャラ配置(PID_ヴァンドレ, ME_IN_C, [服装], Normal, IdleNormal, 0)\nキャラ配置(PID_リンデン, YOU_IN_C, [服装], Normal, IdleNormal, 0)\n\n背景(Map_Event_Hub_Solanel_03_Evening)\nライト(CharaLight_Hub_Evening)\n\nキャラ視線(PID_ヴァンドレ, PID_リンデン, PID_リンデン)\nキャラ視線(PID_リンデン, PID_ヴァンドレ, PID_ヴァンドレ)\nキャラモーション再生(PID_ヴァンドレ, Normal, EmoTalk)\n\nキャラカメラ(CharaCam_FrontLong2_Left_Mid, PID_ヴァンドレ, cam_anim_track_r_slow)\nフェードイン()
MID_RELIANCE_A_#002	キャラカメラ(CharaCam_FrontLong2_Right_Top, PID_リンデン, cam_anim_track_l_slow)\nキャラモーション再生(PID_リンデン, Smile, EmoDeny)
MID_RELIANCE_A_#003	
MID_RELIANCE_A_#004	キャラカメラ(CharaCam_Side_Right2_Mid, PID_リンデン, cam_anim_track_r_slow)\nキャラモーション再生(PID_リンデン, Normal, EmoTalk)
MID_RELIANCE_A_#005	キャラカメラ(CharaCam_Side_Left2_Mid, PID_ヴァンドレ, cam_anim_track_l_slow)\nキャラモーション再生(PID_ヴァンドレ, Sad, EmoDeny2,, 0.5)
MID_RELIANCE_A_#006	キャラカメラ(CharaCam_FrontLong2_Right_Mid, PID_リンデン, cam_anim_track_l_slow)\nキャラモーション再生(PID_リンデン, Smile, EmoDeny2)
MID_RELIANCE_A_#007	キャラカメラ(CharaCam_FrontLong2_Left_Mid, PID_ヴァンドレ, cam_anim_track_r_slow)\nキャラモーション再生(PID_ヴァンドレ, Normal)
MID_RELIANCE_A_#008	キャラカメラ(CharaCam_Side_Right2_Top, PID_リンデン, cam_anim_zoom_out_slow)\nキャラモーション再生(PID_リンデン, Die, EmoNod,, 0.5)
MID_RELIANCE_A_#009	キャラモーション再生(PID_リンデン, Normal)
MID_RELIANCE_A_#010	キャラカメラ(CharaCam_ShoulderLong_Left_Mid, PID_リンデン, cam_anim_track2_l_normal)\nキャラモーション再生(PID_リンデン, Normal, EmoNod,, 0.5)
MID_RELIANCE_A_#011	キャラモーション再生(PID_リンデン, Normal, EmoDeny,, 0.5)
MID_RELIANCE_A_#012	キャラカメラ(CharaCam_FrontLong2_Right_Mid, PID_リンデン, cam_anim_track_l_slow)
MID_RELIANCE_A_#013	キャラモーション再生(PID_リンデン, Normal, EmoTalk,, 0.5)
MID_RELIANCE_A_#014	キャラカメラ(CharaCam_FrontLong2_Left_Mid, PID_ヴァンドレ, cam_anim_track_r_slow)
MID_RELIANCE_A_#015	キャラモーション再生(PID_ヴァンドレ, Normal, EmoDeny,, 0.5)
MID_RELIANCE_A_#016	キャラカメラ(CharaCam_FrontLong2_Right_Mid, PID_リンデン, cam_anim_track_l_slow)\nキャラモーション再生(PID_リンデン, Normal, EmoThinkIn,, 0.5)
MID_RELIANCE_A_#017	キャラカメラ(CharaCam_Front_Center_Top, PID_ヴァンドレ, cam_anim_zoom_in_slow)
MID_RELIANCE_A_#018	キャラカメラ(CharaCam_Front_Center_Top, PID_リンデン, cam_anim_zoom_in_slow)\nキャラモーション再生(PID_リンデン, Smile)
MID_RELIANCE_A_#019	キャラカメラ(CharaCam_Side_Left2_Mid, PID_ヴァンドレ, cam_anim_zoom_out_slow)\nキャラモーション再生(PID_ヴァンドレ, Surprise, EmoJoy)
MID_RELIANCE_A_#020	キャラカメラ(CharaCam_FrontLong2_Right_Top, PID_リンデン, cam_anim_zoom_in_slow)\nキャラモーション再生(PID_リンデン, Smile, EmoThinkOut,, 0.5)
MID_RELIANCE_A_#021	キャラモーション再生(PID_ヴァンドレ, Normal)
MID_RELIANCE_A_#022	キャラカメラ(CharaCam_Side_Left2_Top, PID_リンデン, cam_anim_zoom_out_normal)\nキャラモーション再生(PID_リンデン, Smile, EmoJoy2,, 0.5)
MID_RELIANCE_A_#023	キャラカメラ(CharaCam_Front_Center_Mid, PID_ヴァンドレ, cam_anim_zoom_in_slow)\nキャラモーション再生(PID_ヴァンドレ, Surprise, IdleNormal)\n\nキャラ表示切替(PID_リンデン,False)\n\nキャラカメラ(CharaCam_Side_Left2_Bot, PID_ヴァンドレ, cam_anim_zoom_in_fast, 0.5)\nキャラモーション再生(PID_ヴァンドレ, Surprise, EmoSurprise2, 0.5)\n\n*\nパペット会話中断()\nキャラ表示切替(PID_リンデン,True)\nウェイト(1.0)
MID_RELIANCE_A_#024	キャラカメラ(CharaCam_FrontLong2_Right_Mid, PID_リンデン, cam_anim_track_l_slow)\nキャラモーション再生(PID_リンデン, Normal)
MID_RELIANCE_A_#025	キャラカメラ(CharaCam_Front_Center_Top, PID_ヴァンドレ, cam_anim_zoom_out_slow)\nキャラモーション再生(PID_ヴァンドレ, Die, EmoThinkIn)\nキャラモーション再生(PID_ヴァンドレ, Strike, EmoThinkLoop, 3.5,1)\n\n*\nパペット会話中断()\nキャラモーション待ち(PID_ヴァンドレ)
MID_RELIANCE_A_#026	キャラカメラ(CharaCam_FrontLong2_Right_Mid, PID_リンデン, cam_anim_track_l_slow)\n\nキャラモーション再生(PID_リンデン, Smile, EmoTalk2)\nキャラモーション再生(PID_ヴァンドレ, Smile, EmoThinkOut)
MID_RELIANCE_A_#027	
MID_RELIANCE_A_#028	キャラカメラ(CharaCam_Front_Center_Mid, PID_ヴァンドレ, cam_anim_zoom_in_slow)\nキャラモーション再生(PID_ヴァンドレ, Smile, EmoDeny2)
MID_RELIANCE_A_#029	キャラカメラ(CharaCam_Front_Center_Mid, PID_リンデン, cam_anim_zoom_in_slow)\nキャラモーション再生(PID_リンデン, Smile, EmoJoy)\n*\nフェードアウト()
