MID_FRIENDLIST_Vandre_TextD	【初期兵種】聖騎士\n【生日】11月26日\n【備註】第三十二代的龍之守護者。\n在浮遊島上的離宮索拉涅爾，\n負責照顧沉眠於此的\n\x0E\x06\x03\x00生活起居。
MID_FRIENDLIST_Vandre_TextC	【喜歡的事物】\n裁縫、打掃、寫作、\n水果、安靜的地方、毛線球\n【不喜歡的事物】\n奇珍異味、宴會、味道強烈的東西、\n專注時被打斷、睡過頭
MID_FRIENDLIST_Vandre_TextB	【興趣】待在安靜的場所\n【專長】編織蕾絲、製作果醬\n【經歷】來自聖地里特司的聚落，\n生於代代侍奉神龍的家族。\n在里特司，服侍於王城的神職人員\n會被分至各個聚落過著平靜的生活。\n凡德雷的能力獲得前任守護者\n高度讚賞，因此被指定為繼任者。
MID_FRIENDLIST_Vandre_TextA	【身高】190cm\n【無名指的戒圍】22號\n【個性】認真嚴格，經驗老道。\n總是默默地完成分內的工作，\n但有時也會展現親切的一面。\n將守護者的使命放在首位，\n並決心將此生奉獻給神龍。\n是軍中最擅長封蠟的人。
MID_FRIENDLIST_Vandre_TextS	【成為搭檔後】\n雖為避免公私不分，\n在眾人面前表現得一如既往，\n卻有人說凡德雷看你的視線\n好像比從前更溫柔些了。\n由於擔心傷到約定戒指，\n就算不常戴著，\n每晚仍會仔細保養。
MID_FRIENDLIST_Clan_TextD	【初期兵種】魔法師\n【生日】3月10日\n【備註】芙嵐的雙胞胎哥哥。\n為凡德雷的後繼者，\n第三十三代的龍之守護者。\n神龍\x0E\x06\x03\x00甦醒之際，\n柯嵐正隨侍在側。
MID_FRIENDLIST_Clan_TextC	【喜歡的事物】\n神龍、打掃、學習、下廚、讀書、\n醃菜、哲學書籍\n【不喜歡的事物】\n蟲子、運動、鬼故事、\n動物以外的交通工具、\n心情不好時的自己
MID_FRIENDLIST_Clan_TextB	【興趣】照顧神龍大人的生活起居\n【專長】製作醃菜、背誦詩歌\n【經歷】來自聖地里特司的聚落。\n生於神職世家，從小就時常\n進出索拉涅爾。凡德雷為柯嵐的\n遠房親戚，且十分讚賞柯嵐對\n神龍\x0E\x06\x03\x00的悉心照料，\n拔擢他成為下一任守護者。
MID_FRIENDLIST_Clan_TextA	【身高】160cm\n【無名指的戒圍】9號\n【個性】性格內斂且思慮周詳，\n但遇有興趣的事會變得十分狂熱。\n總是能掌握要領，順利完成任務。\n和芙嵐一起成立了神龍的\n粉絲後援會，並擔任會長一職。\n是軍中最擅長棋盤遊戲的人。
MID_FRIENDLIST_Clan_TextS	【成為搭檔後】\n因為擔心踰矩，在眾人面前\n還是表現得如往常一樣拘謹，\n等到兩人獨處時才會稍微主動些。\n會在獨自一人時戴上約定戒指，\n凝視戒指，細細品嘗幸福的滋味。\n希望總有一天要長得比你高，\n緊緊貼在身旁守護你。
MID_FRIENDLIST_Fram_TextD	【初期兵種】僧侶\n【生日】3月10日\n【備註】柯嵐的雙胞胎妹妹。\n為凡德雷的後繼者，\n第三十三代的龍之守護者。\n神龍\x0E\x06\x03\x00甦醒之際，\n芙嵐正隨侍在側。
MID_FRIENDLIST_Fram_TextC	【喜歡的事物】\n神龍、花、時尚、運動、\n甜菜、替別人加油\n【不喜歡的事物】\n打掃、學習、鬼故事、難懂的書、\n碎碎念、被自己絆倒時的難堪
MID_FRIENDLIST_Fram_TextB	【興趣】崇拜神龍大人\n【專長】評鑑甜菜、後空翻\n【經歷】來自聖地里特司的聚落。\n生於神職世家，從小就時常\n進出索拉涅爾。凡德雷為芙嵐的\n遠房親戚，且十分讚賞芙嵐對\n神龍\x0E\x06\x03\x00的熱情以待，\n拔擢他成為下一任守護者。
MID_FRIENDLIST_Fram_TextA	【身高】160cm\n【無名指的戒圍】7號\n【個性】好勝活潑。\n身為守護者，工作態度十分積極，\n但是常因粗心大意而招致失敗。\n和柯嵐一起成立了神龍的\n粉絲後援會，並擔任名譽會長一職。\n是軍中迴旋踢技巧最為精湛的人。
MID_FRIENDLIST_Fram_TextS	【成為搭檔後】\n和往常一樣，見到你就非常開心，\n並盡情為你加油打氣。\n兩人獨處時則表現得較為沉穩。\n為了避免自己弄丟約定戒指，\n將戒指收藏在寶箱之中，\n盼望有天成為成熟的大人以後，\n可以隨時隨地戴著戒指。
MID_FRIENDLIST_Alfred_TextD	【初期兵種】王室貴族\n【生日】8月8日\n【備註】費列聶王國的第一王子。\n神龍王城遇襲的夜晚，\n率領布修隆、艾媞耶兩名臣子，\n一同奔赴王城支援。
MID_FRIENDLIST_Alfred_TextC	【喜歡的事物】\n鍛鍊、運動、音樂、花、\n肌肉、晨曦、四葉幸運草、\n他人的幸福\n【不喜歡的事物】\n繁瑣的工作、裁縫、辣的食物、\n失眠的夜晚、後悔
MID_FRIENDLIST_Alfred_TextB	【興趣】鍛鍊肌肉、和人聊天\n【專長】早睡早起、製作花圈\n【經歷】生為費列聶王國的王子，\n以王位第一順位繼承者被養育成人。\n年幼時體弱多病，\n為了強身健體而勤於鍛鍊，\n終究培養出強健的體魄。\n並將亡父生前傳授的槍術登峰造極。
MID_FRIENDLIST_Alfred_TextA	【身高】177cm\n【無名指的戒圍】12號\n【個性】善良且溫仁謙遜，\n乍看是一名相當典型的王族，\n內在卻相當豪邁且忠於自我。\n喜歡在生活中尋找小確幸。\n偶爾也會想要一人獨處。\n是軍中身上散發最濃郁花香的人。
MID_FRIENDLIST_Alfred_TextS	【成為搭檔後】\n四處向夥伴炫耀\n自己每天都過得很幸福，\n並製作了花冠送給你。\n為了能和長壽的你長相廝守，\n比以往更加勤奮地鍛鍊身體。\n將約定戒指收在有花朵刺繡的袋中，\n藏在衣服的某處隨身攜帶。
MID_FRIENDLIST_Boucheron_TextD	【初期兵種】斧戰士\n【生日】5月11日\n【備註】費列聶王國的王城騎士。\n神龍王城遇襲的夜晚，\n與主子阿爾弗雷德王子\n以及同袍艾媞耶，\n一同奔赴王城支援。
MID_FRIENDLIST_Boucheron_TextC	【喜歡的事物】\n讀書、釣魚、散步、自然、\n已經熟悉的路、喜劇故事\n【不喜歡的事物】\n繁瑣的工作、鬼故事、\n第一次走的路、悲劇故事
MID_FRIENDLIST_Boucheron_TextB	【興趣】在大自然中讀書\n【專長】體力活、品水\n【經歷】來自費列聶王國內一座\n有著澄淨流水的城鎮之伯爵家。\n生為次男，有位體格健壯的兄長。\n由於雙親皆與王族頻繁交流，\n自幼便結識了阿爾弗雷德王子，\n並在年幼時即被指名擔任其臣子。
MID_FRIENDLIST_Boucheron_TextA	【身高】190cm\n【無名指的戒圍】21號\n【個性】心地善良、相當感性。\n受到感動眼淚便會奪眶而出。\n人們經常找他談論自己的煩惱。\n由於出身貴族，大多時候都\n乘坐馬車，因此方向感不太好。\n是軍中最具包容力的人。
MID_FRIENDLIST_Boucheron_TextS	【成為搭檔後】\n在一天結束時會待在你身邊，\n靜靜地聆聽你說話。\n在眾人面前一如往常地可靠，\n但在兩人獨處時則變得十分熱情。\n每當看著約定戒指就會感動到落淚，\n因此唯有重要時刻\n才會小心翼翼地戴在手上。
MID_FRIENDLIST_Etie_TextD	【初期兵種】弓箭手\n【生日】10月1日\n【備註】費列聶王國的王城騎士。\n神龍王城遇襲的夜晚，\n與主子阿爾弗雷德王子\n以及同袍布修隆，\n一同奔赴王城支援。
MID_FRIENDLIST_Etie_TextC	【喜歡的事物】\n鍛鍊、茶會、花、肉、\n味道有趣的肌肉增強劑\n【不喜歡的事物】\n繁瑣的工作、打掃、裁縫、\n無法靠腕力解決的事
MID_FRIENDLIST_Etie_TextB	【興趣】所有活動身體的事\n【專長】延長切花的壽命\n【經歷】來自費列聶王國，\n為花田小鎮內名門侯爵之女。\n有著年齡差距較大的兄姊。\n自幼便結識了錫莉奴，\n也是經錫莉奴介紹才開始對\n肌肉鍛鍊產生興趣並每日訓練。
MID_FRIENDLIST_Etie_TextA	【身高】154cm\n【無名指的戒圍】13號\n【個性】品格高尚，看似高傲，\n其實只是個性相當積極進取。\n每天都專心於強身健體，\n為此甚至不惜投入時間研究。\n遇到煩惱都會倚靠活動身體解決。\n是軍中跑得最快的人。
MID_FRIENDLIST_Etie_TextS	【成為搭檔後】\n比任何人都還要擔心你的身體，\n總是在你疲憊時，為你代勞\n「打開拴緊的瓶蓋」等體力活。\n能在閒暇之餘和你一起慢跑，\n比世上任何事都還要令他感到幸福。\n為了徹底防止自己弄壞約定戒指，\n將戒指放在花型收納盒中收藏。
MID_FRIENDLIST_Celine_TextD	【初期兵種】王室貴族\n【生日】12月18日\n【備註】費列聶王國的第一公主。\n阿爾弗雷德的妹妹。\n有路易、克蘿艾兩名臣子。\n帶著「慈悲公主戒指」\n在弗魯魯風車村加入神龍軍。
MID_FRIENDLIST_Celine_TextC	【喜歡的事物】\n茶會、花、閱讀、時尚、\n紅茶、小鳥、同伴的幸福\n【不喜歡的事物】\n辣的食物、武器、\n戰爭、幸福過度、\n被迫積極面對事物
MID_FRIENDLIST_Celine_TextB	【興趣】邀請他人一同品茶\n【專長】猜中茶葉的產地\n【經歷】生為費列聶王國的公主，\n在家族與國民的關愛之下成長。\n年幼時相當愛哭，\n但當身為國王的父親崩殂後，\n訓誡自己得成為母親與兄長的後盾，\n勤於鍛鍊學習，練就出強韌的心志。
MID_FRIENDLIST_Celine_TextA	【身高】155cm\n【無名指的戒圍】6號\n【個性】開朗且平易近人。\n品學兼優，事事皆能掌握要領，\n為了維持和平願意不惜一戰。\n雖然經常吐槽兄長阿爾弗雷德，\n但比誰都還要關心他。\n是軍中最為辯才無礙的人。
MID_FRIENDLIST_Celine_TextS	【成為搭檔後】\n每日一同品茶度過閑靜時光，\n已成了兩人的既定行程。\n就算在戰鬥中遭遇到痛苦，\n也會互相扶持、相濡以沫。\n錫莉奴素來喜愛芍藥，約定戒指\n便擺在芍藥造型的台座上收著，\n而兩人獨處時一定會戴著戒指。
MID_FRIENDLIST_Louis_TextD	【初期兵種】重槍兵\n【生日】11月4日\n【備註】費列聶王國的王城騎士。\n在弗魯魯風車村\n為了讓主子錫莉奴逃走，\n和同袍克蘿艾攜手作戰。\n此役後加入神龍軍。
MID_FRIENDLIST_Louis_TextC	【喜歡的事物】\n茶會、下廚、花、妄想、\n同伴們感情和睦、葡萄\n【不喜歡的事物】\n工藝、特辣的食物、海葡萄、\n看不透真心的人、\n感官靈敏的人
MID_FRIENDLIST_Louis_TextB	【興趣】在一旁觀察同伴\n【專長】照顧別人、泡茶\n【經歷】來自費列聶王國。\n生於種植葡萄之村莊的平民。\n為了扶養三個弟弟而立志成為騎士，\n能力受肯定被拔擢為錫莉奴的臣子。\n在費列聶王國，非出身貴族\n而成為王族的臣子實為罕事。
MID_FRIENDLIST_Louis_TextA	【身高】178cm\n【無名指的戒圍】18號\n【個性】彬彬有禮，\n具備騎士與管家應有的素養。\n總是在意同伴的狀況，看著同伴間\n相處和睦的景象就能感到幸福。\n情緒一有波動便會露出凝重表情。\n是軍中最懂得預測天氣的人。
MID_FRIENDLIST_Louis_TextS	【成為搭檔後】\n不僅比以前還來得還要溫柔，\n更是無微不至地細心照顧你。\n比起花時間觀察同伴們的互動，\n選擇將更多時間拿來照看你。\n把約定戒指保養得閃閃發亮，\n打算總有一天也要回送你一個\n自己親手製作的對戒。
MID_FRIENDLIST_Chloe_TextD	【初期兵種】槍飛馬騎士\n【生日】4月27日\n【備註】費列聶王國的王城騎士。\n在弗魯魯風車村\n為了讓主子錫莉奴逃走，\n和同袍路易攜手作戰。\n此役後加入神龍軍。
MID_FRIENDLIST_Chloe_TextC	【喜歡的事物】\n童話故事、奇珍異味、妄想、動物、\n從空中眺望景色、重口味食物\n【不喜歡的事物】\n下廚、打掃、曬太陽、\n清淡的食物、分量少的餐點、\n貴族子女應有的言行舉止
MID_FRIENDLIST_Chloe_TextB	【興趣】吃遍攤販、空中散步\n【專長】投擲、大胃王\n【經歷】來自費列聶王國內，\n距海不遠的城鎮中的侯爵之女。\n有個未來要繼承爵位的兄長。\n為了長大成人後嫁給門當戶對的\n男性，克蘿艾自幼便接受各式教育，\n但偶遇錫莉奴後立志成為王城騎士。
MID_FRIENDLIST_Chloe_TextA	【身高】167cm\n【無名指的戒圍】11號\n【個性】散發穩重氣質的淑女。\n喜歡童話故事與美麗的風景，\n總是在同伴中探尋美如畫的配對。\n非常喜歡奇珍異味，即使吃了許多\n來路不明的食物也不會鬧肚子。\n是軍中最擅長投擲的人。
MID_FRIENDLIST_Chloe_TextS	【成為搭檔後】\n雖然還是致力於尋找如同詩畫般\n美好的配對，但最近開始說起：\n「我們這一對就是最美的景緻。」\n當你疲憊時會讓你躺在腿上小憩，\n還會與你分享私藏的奇珍異味。\n將約定戒指放在使用飛馬羽毛\n製成的美麗收納盒裡保管。
MID_FRIENDLIST_Diamand_TextD	【初期兵種】領主\n【生日】4月6日\n【備註】布羅帝亞王國的第一王子\n有安巴、潔德兩名臣子。\n於城門親自迎接前來求取\n交由布羅帝亞託管之\n紋章士戒指的神龍一行人。
MID_FRIENDLIST_Diamand_TextC	【喜歡的事物】\n武器、鍛鍊、釣魚、肉、學習、\n家人、幽靜的場所\n【不喜歡的事物】\n宴會、可愛的事物、炎之魔法、\n味道強烈的東西、被投注過度期待
MID_FRIENDLIST_Diamand_TextB	【興趣】品味趣聞軼事\n【專長】誇獎他人、速讀\n【經歷】生為第一王子，\n自幼便接受身為王者應受的教育。\n莫力翁王更是親自傳授武功，\n因此他打從心底尊敬父親。\n但他認為力量不該用於擴張領土，\n應當花在治理上，方能使民富國強。
MID_FRIENDLIST_Diamand_TextA	【身高】188cm\n【無名指的戒圍】21號\n【個性】個性剛毅質樸、認真正直。\n每當自身獲得成長便會欣喜萬分。\n眾望所歸的布羅帝亞繼任王者。\n行事作風光明磊落、不卑不亢，\n並且毫不吝於稱讚他人。\n是軍中一被逗笑就停不下來的人。
MID_FRIENDLIST_Diamand_TextS	【成為搭檔後】\n雖然言行舉止與以往大致相同，\n但不論是在索拉涅爾或戰場上，\n最牽掛也最在乎的都是你。\n每當你偶爾戴上布羅帝亞的戒指，\n他總是表現得欣喜若狂。\n平時把約定戒指收在絲綢袋中，\n戰鬥時一定會將戒指藏在胸懷。
MID_FRIENDLIST_Umber_TextD	【初期兵種】槍騎士\n【生日】2月3日\n【備註】布羅帝亞王國的王城士兵。\n當布羅帝亞王城遭遇襲擊時。\n快馬加鞭自國境返回王城。\n以援軍之姿急忙趕到神龍\n以及主子帝亞曼德身旁。
MID_FRIENDLIST_Umber_TextC	【喜歡的事物】\n乳製品、薯類、動物、下廚、\n帥氣的事物、傳說、羊駝\n【不喜歡的事物】\n裁縫、打掃、奇珍異味、難懂的書、\n毫無浪漫可言的事物、謊言
MID_FRIENDLIST_Umber_TextB	【興趣】追尋傳說與浪漫\n【專長】羊駝語、照顧動物\n【經歷】來自布羅帝亞王國，\n生於羊駝之鄉中的某座牧場。\n不甘被困在鄉下，經嚴苛的特訓後\n於國內的武術大會取得優異成績，\n進而被拔擢為王族的臣子。\n在故鄉被稱為「羊駝之鄉的奇蹟」。
MID_FRIENDLIST_Umber_TextA	【身高】185cm\n【無名指的戒圍】17號\n【個性】單純且熱情。\n熱衷於蒐集世界各地的傳奇軼事，\n不論其可信度高與低都瞭若指掌。\n容易引發奇妙的騷動，天生會讓\n「事情的發展出人意料」。\n是軍中最擅長吹口哨的人。
MID_FRIENDLIST_Umber_TextS	【成為搭檔後】\n每當看到你都會露出開心的笑容，\n不僅幽默風趣，更是在背後\n扶持著你，是相當值得倚靠的搭檔。\n有時兩人也會使用羊駝語交談，\n令其他同伴都感到十分不可思議。\n將約定戒指保管在自製的木盒中，\n讓戒指像傳說秘寶般沉眠在房內。
MID_FRIENDLIST_Jade_TextD	【初期兵種】重斧兵\n【生日】12月7日\n【備註】布羅帝亞王國的王城士兵。\n與伊爾席翁王國全面開戰之際，\n正巧在國境負責警備任務。\n於是便直接在戰場上與\n主子帝亞曼德以及神龍會合。
MID_FRIENDLIST_Jade_TextC	【喜歡的事物】\n寫作、妄想、散步、閱讀、動物、\n礦石、快樂的事、開朗的人\n【不喜歡的事物】\n宴會、時尚、面露微笑、\n沒有靈感的時候
MID_FRIENDLIST_Jade_TextB	【興趣】寫小說\n【專長】鑑定礦石、冥想\n【經歷】來自布羅帝亞王國，\n生於以採礦聞名的礦山城鎮。\n在家中五個孩子裡排行老三。\n曾做過鎮上礦山的警備人員，\n人稱「鐵壁潔德」。在贏得武術\n大會勝利後獲拔擢為王族家臣。
MID_FRIENDLIST_Jade_TextA	【身高】170cm\n【無名指的戒圍】12號\n【個性】冷靜、忠於任務。\n雖然在戰場上被評為冷酷無情，\n其實為人十分爽朗，喜歡有趣的事。\n寫了一本相當荒誕的小說，\n自己的主子對其作品讚譽有加。\n在軍中是最常夢到清醒夢的人。
MID_FRIENDLIST_Jade_TextS	【成為搭檔後】\n原本不太習慣兩人獨處，\n現在也能自然地綻露笑容了。\n雖然現在還不能告訴你，\n但正偷偷地撰寫神龍與騎士\n過著幸福美滿日子的故事。\n為免約定戒指受到任何一絲傷害，\n將戒指收在以礦石打造的牢固箱子。
MID_FRIENDLIST_Staluke_TextD	【初期兵種】領主\n【生日】10月15日\n【備註】布羅帝亞王國的第二王子。\n有菈琵思、希特麗妮卡兩名臣子。\n在費列聶與布羅帝亞國境一帶，\n將神龍等人誤認成盜賊以致誤擊。\n得知眾人身分後立刻下跪謝罪。
MID_FRIENDLIST_Staluke_TextC	【喜歡的事物】\n閱讀、散步、魚、學習、釣魚、\n除了敵人與自己以外的所有人\n【不喜歡的事物】\n宴會、時尚、曬太陽、\n客套話、稱讚、自己
MID_FRIENDLIST_Staluke_TextB	【興趣】躲在陰暗的角落\n【專長】發現別人的優點\n【經歷】生為第二王子，\n成長過程中總是聽到旁人\n稱讚自己那幾近完美的兄長，\n因此造就了自卑的性格。\n雖然父母與人民都認可他的實力，\n本人卻渾然不知。
MID_FRIENDLIST_Staluke_TextA	【身高】172cm\n【無名指的戒圍】16號\n【個性】思想消極、總是自我否定。\n個性雖悲觀，老是認為所有人都比\n自己優秀，但仍有一定的社交能力，\n擁有不輕易傷害他人的善良性格。\n具備王族應有的膽識。\n是軍中頭髮最柔順亮麗的人。
MID_FRIENDLIST_Staluke_TextS	【成為搭檔後】\n每見到你就會露出害羞的笑容，\n偷偷地向你揮揮手。\n兩人獨處時並不會特別自卑，\n反而能坦率地表達自己的心意。\n雖然總是說著自己不勝惶恐，\n沒有資格戴上約定戒指。\n其實每晚都悄悄戴著戒指入眠。
MID_FRIENDLIST_Lapis_TextD	【初期兵種】刀劍戰士\n【生日】5月25日\n【備註】布羅帝亞王國的王城士兵。\n和主子史塔盧克及同袍希特麗妮卡，\n三人一同守衛與費列聶接壤的國境。\n起初雖然將神龍一行誤認為敵人，\n最終順利解開誤會，冰釋前嫌。
MID_FRIENDLIST_Lapis_TextC	【喜歡的事物】\n薯類、工藝、裁縫、鍛鍊、動物、\n可以食用的草、可以利用的木材\n【不喜歡的事物】\n高級品、時尚、\n高尚的場所、上流社會
MID_FRIENDLIST_Lapis_TextB	【興趣】狩獵、觀察與栽培植物\n【專長】體力活、手工藝\n【經歷】來自布羅帝亞王國，\n生於土地貧脊，專門產薯的村莊。\n家中相當貧窮，連三餐都沒著落。\n因此積極鍛鍊，好成為酬勞優渥的\n王城士兵。經狩獵練成的怪力助他\n在武術大會奪勝，成為王族臣子。
MID_FRIENDLIST_Lapis_TextA	【身高】160cm\n【無名指的戒圍】7號\n【個性】個性善良溫柔。\n擁有與柔弱外型不符的怪力。\n擅長利用石頭、樹枝製作任何物品，\n並且擅於分辨可食用的野草。\n總是寄錢回家貼補家用。\n在軍中是最擅長猜拳的人。
MID_FRIENDLIST_Lapis_TextS	【成為搭檔後】\n兩人在索拉涅爾一隅種植植物，\n並見證植物成長茁壯。\n喜歡在有空時一起製作工藝品，\n但仍吃不慣你每次休息時間都會\n拿出來一起享用的高級點心。\n將約定戒指收在使用自己\n珍藏的石子所打造的盒子內。
MID_FRIENDLIST_Citrinica_TextD	【初期兵種】魔法師\n【生日】11月9日\n【備註】布羅帝亞王國的王城士兵。\n和主子史塔盧克及同袍菈琵思，\n三人一同守衛與費列聶接壤的國境。\n起初雖然將神龍一行誤認為敵人，\n最終順利解開誤會，冰釋前嫌。
MID_FRIENDLIST_Citrinica_TextC	【喜歡的事物】\n茶會、高級品、童話故事、學習、\n花、放鬆的時間、舞會、\n同伴們開心的表情\n【不喜歡的事物】\n裁縫、工藝、下廚、\n看不見回報的鍛鍊
MID_FRIENDLIST_Citrinica_TextB	【興趣】贈送朋友禮物\n【專長】收購、協商、努力不懈\n【經歷】來自布羅帝亞王國，\n為親王之女，上有兩名兄長。\n為帝亞曼德、史塔盧克之堂親。\n憑藉著血緣關係方成為家臣，\n因此時常擔心自己實力是否足夠。
MID_FRIENDLIST_Citrinica_TextA	【身高】163cm\n【無名指的戒圍】8號\n【個性】心地善良，為朋友著想。\n在眾人疼愛下無憂無慮地長大成人，\n因此希望自己也能給予回報，\n會運用自己的財富來寵溺旁人。\n一放鬆眼神反而會有點帶刺。\n是軍中擁有最多土地的人。
MID_FRIENDLIST_Citrinica_TextS	【成為搭檔後】\n不停向你訴說飽含心意的話語，\n並以此代替昂貴的禮物。\n夢想著希望終有一天\n兩人能夠連袂出席舞會。\n將約定戒指擺放在奢華的台座上，\n並將收到戒指當天撿到的石頭\n放在一旁當作裝飾。
MID_FRIENDLIST_Ivy_TextD	【初期兵種】馴獸師\n【生日】11月17日\n【備註】伊爾席翁王國第一公主。\n有傑爾科巴、花月兩名臣子。\n雖然有一段時間曾因聽命於\n父親海亞信斯王而與神龍敵對，\n但後來帶著紋章士戒指於影子原野\n和神龍軍會合並加入其陣營。
MID_FRIENDLIST_Ivy_TextC	【喜歡的事物】\n神龍、茶會、閱讀、學習、香草、\n安靜的地方、舒服的風\n【不喜歡的事物】\n鬼故事、動物、蟲子、宴會、\n曬太陽、味道強烈的東西、\n鬼怪、吵雜的地方、難纏的人
MID_FRIENDLIST_Ivy_TextB	【興趣】無特別嗜好\n【專長】隱藏自己的真心\n【經歷】海亞信斯王正室的女兒。\n身為第一公主、王位繼承人，\n自幼即被捲入大人們的權力鬥爭，\n無法像普通孩子一樣快樂成長。\n直到幾年前都還在學校就讀，\n畢業後回到城裡，履行公主的義務。
MID_FRIENDLIST_Ivy_TextA	【身高】172cm\n【無名指的戒圍】8號\n【個性】拘謹、嫻靜的女性。\n無法輕易信任他人、敞開心扉，\n但會對喜歡的人表現強烈的執念。\n對神龍有著近似崇拜的感情。\n其實相當膽小且害怕鬼故事。\n是軍中膚況最佳的人。
MID_FRIENDLIST_Ivy_TextS	【成為搭檔後】\n會親口向你訴說情意，\n也比以前更常綻露笑容了。\n最珍惜的是兩人能獨處的時間，\n每到分開時總是顯得離情依依。\n為了確保不會弄丟約定戒指，\n將戒指收在房間內的金色小盒。\n雖從不帶出門，看著便能深感幸福。
MID_FRIENDLIST_Zelkova_TextD	【初期兵種】小偷\n【生日】8月2日\n【備註】伊爾席翁王國的王城士兵。\n曾有一段時間和主子艾比公主，\n以及同袍花月一同與神龍敵對，\n後來帶著紋章士戒指於影子原野\n和神龍軍會合並加入其陣營。
MID_FRIENDLIST_Zelkova_TextC	【喜歡的事物】\n工藝、裁縫、閱讀、下廚、\n繁瑣的工作、墓地、忙碌的時間、\n活力十足的小孩\n【不喜歡的事物】\n味道強烈的東西、宴會、童話故事、\n無趣、熱情退卻的瞬間
MID_FRIENDLIST_Zelkova_TextB	【興趣】所有事\n【專長】耐人尋味的發言、調配藥物\n【經歷】來自伊爾席翁王國，\n生於森林城鎮的富裕家庭。\n父母與雙胞胎弟弟皆為盜賊所殺，\n為了復仇而親身下海成了暗殺者。\n復仇成功後，其實力為王家相中，\n進而任命為王城士兵。
MID_FRIENDLIST_Zelkova_TextA	【身高】185cm\n【無名指的戒圍】15號\n【個性】專心致志且興趣廣泛。\n對任何事都會發表意味深長的評論。\n有著會挹注熱情在想做的事情上，\n並從中獲取快感的特質。\n雖然喜歡小孩，但是被小孩們討厭。\n是軍中睡眠最為不足的人。
MID_FRIENDLIST_Zelkova_TextS	【成為搭檔後】\n雖然興趣依舊廣泛，但也昭告天下\n自己在你身上傾注了最大的熱情。\n兩人獨處時說話直白而不加修飾，\n毫無耐人尋味的影子。\n約定戒指平時都放在能上鎖的盒內，\n而盒子的鑰匙又鎖在另一個盒子中，\n徹底而嚴密地收藏起來。
MID_FRIENDLIST_Kagetsu_TextD	【初期兵種】刀劍將領\n【生日】12月22日\n【備註】伊爾席翁王國的王城士兵。\n曾有一段時間和主子艾比公主，\n以及同袍傑爾科巴一同與神龍敵對，\n後來帶著紋章士戒指於影子原野\n和神龍軍會合並加入其陣營。
MID_FRIENDLIST_Kagetsu_TextC	【喜歡的事物】\n武器、宴會、玩耍、鍛鍊、魚、\n攜帶式食品、和食、飯糰、\n願意和自己交手的人\n【不喜歡的事物】\n打掃、閱讀、下廚、乳製品、\n連續吃西餐、冷淡的態度
MID_FRIENDLIST_Kagetsu_TextB	【興趣】比試、約會\n【專長】踢館、交朋友、預知未來\n【經歷】來自索爾姆王國，\n出生於秘境──白色沙漠。\n雖為當地王公貴族的繼承人，\n卻不滿於自己對外界的無知，\n因而留下書信便離鄉踏上旅途。\n後為了尋找高手前往伊爾席翁。
MID_FRIENDLIST_Kagetsu_TextA	【身長】178cm\n【無名指的戒圍】17號\n【個性】開朗且不怕生，\n一旦聊過天就會把人當作朋友。\n為人毫無算計亦無城府。\n母親為巫女的花月也擁有預知能力，\n但能預知的事情有些難以言喻。\n是軍中最喜歡飯糰的人。
MID_FRIENDLIST_Kagetsu_TextS	【成為搭檔後】\n比以前更大方地表露情感，\n每次見面總是不避諱地表白心意。\n到了戰鬥時則投以嚴肅的眼神，\n一絲不苟地守護在你左右。\n收到約定戒指之後非常高興，\n不論去哪都會戴在手上，\n有好幾次都差點不小心弄丟。
MID_FRIENDLIST_Hortensia_TextD	【初期兵種】馴獸師\n【生日】6月3日\n【備註】伊爾席翁王國第二公主。\n和艾比為同父異母姊妹，\n有羅薩德、戈爾德瑪莉兩名臣子。\n雖聽命於父親海亞信斯王，\n三番兩次與神龍軍為敵，\n最後在索爾姆王城被說服成為同伴。
MID_FRIENDLIST_Hortensia_TextC	【喜歡的事物】\n時尚、可愛的事物、高級品、花、\n親人、所有同伴、\n稱讚自己可愛的人\n【不喜歡的事物】\n辣的食物、運動、蟲子、下廚、\n曬太陽、和親人分離、\n比自己更可愛的人
MID_FRIENDLIST_Hortensia_TextB	【興趣】購物、嘗試美容方法\n【專長】背誦魔法書、紙上兵推演練\n【經歷】海亞信斯王側室之女。\n年幼時雖亦有其他兄弟姊妹，\n但皆在正室的排斥下離王城而去，\n因而成為了第二公主。\n原本是名還在學校就讀的學生，\n在父王的指示下回到了王城。
MID_FRIENDLIST_Hortensia_TextA	【身高】149cm\n【無名指的戒圍】6號\n【個性】充滿自信又有些許任性。\n對自己可愛的外貌相當自豪。\n在學校是名成績優異的跳級生，\n能迅速理解自身職責並妥善執行。\n內心十分善良，非常重感情。\n在軍中是最會拋媚眼放電的人。
MID_FRIENDLIST_Hortensia_TextS	【成為搭檔後】\n每天一定都會來找你，\n向你撒嬌說想陪你一起。\n獨處時有著與年紀相符的嬌羞，\n卻也急於向你展現成熟的模樣。\n將約定戒指收在母親留給他的\n寶石盒裡珍藏著，暗自決定\n下次要將戒指戴在無名指上。
MID_FRIENDLIST_Rosado_TextD	【初期兵種】飛龍騎士\n【生日】1月19日\n【備註】伊爾席翁王國的王城士兵。\n曾隨主子奧爾坦希亞公主，\n以及同袍戈爾德瑪莉三人\n與神龍軍二度交戰。最後帶著\n「碧綠風空戒指」於紺碧海岸\n和神龍軍會合並加入其陣營。
MID_FRIENDLIST_Rosado_TextC	【喜歡的事物】\n時尚、可愛的事物、花、宴會、\n繪畫、繪圖工具、美麗的風景、\n慵懶地消磨時間\n【不喜歡的事物】\n學習、難懂的書、曬太陽、壓抑、\n令人提不起勁的事物、拘泥古板
MID_FRIENDLIST_Rosado_TextB	【興趣】尋找心動的事物、睡午覺\n【專長】繪圖、速寫\n【經歷】來自伊爾席翁王國。\n生於神秘之湖附近的妖精之村。\n為家中獨子，與父親形肖神似。\n邪龍復活時他雖還只是個學生，\n仍因掛心獨自回城的奧爾坦希亞，\n與戈爾德瑪莉兩人決定一同隨行。
MID_FRIENDLIST_Rosado_TextA	【身高】169cm\n【無名指的戒圍】11號\n【個性】追求可愛與美，\n歌頌人生美好的樂天派。\n喜歡把美好的風景畫下來，\n貼在顯眼的地方觀察別人反應。\n喜歡替愛龍搭配穿搭。\n是軍中最擅長綁緞帶的高手。
MID_FRIENDLIST_Rosado_TextS	【成為搭檔後】\n每天都會用心稱讚你很可愛，\n從不吝於對你說些甜言蜜語。\n筆下描繪出的你也越漸出色，\n夥伴都誇讚能從中感受到愛。\n如同收到約定戒指那天所言，\n一直將戒指帶著片刻不離身，\n但僅在兩人獨處時才會戴上。
MID_FRIENDLIST_Goldmary_TextD	【初期兵種】無畏英雄\n【生日】7月18日\n【備註】伊爾席翁王國的王城士兵。\n曾隨主子奧爾坦希亞公主，\n以及同袍羅薩德三人\n與神龍軍二度交戰。最後帶著\n「碧綠風空戒指」於紺碧海岸\n和神龍軍會合並加入其陣營。
MID_FRIENDLIST_Goldmary_TextC	【喜歡的事物】\n時尚、可愛的事物、打掃、下廚、\n花、溫泉、稱讚的話、自己\n【不喜歡的事物】\n武器、鍛鍊、堅硬的食物、曬太陽、\n不懂自己魅力的人
MID_FRIENDLIST_Goldmary_TextB	【興趣】照鏡子、梳理毛髮\n【專長】做便當、淚眼哀求\n【經歷】來自伊爾席翁王國。\n獨生女，家中於溫泉勝地經營旅宿，\n在父母與旅人們的關愛下成長。\n邪龍復活時還只是名學生，\n因掛心獨自回城的奧爾坦希亞，\n與羅薩德兩人決定一同隨行。
MID_FRIENDLIST_Goldmary_TextA	【身高】173cm\n【無名指的戒圍】9號\n【個性】內向又總是畏畏縮縮，\n但其實臉皮有點厚，常口出狂言。\n非常自戀，四處宣揚自己的魅力，\n以便在各方面都能吸引人目光。\n有著一雙巧手，擅長所有家事。\n是軍中對泉質見解最為獨到的人。
MID_FRIENDLIST_Goldmary_TextS	【成為搭檔後】\n雖然還是一直在自誇，\n但現在每天都會稱讚你一番，\n並向同伴誇口自己有多幸福。\n每次戰鬥前總會帶給你充滿愛意的\n手作愛心便當。令人意外的是，\n他似乎並未特地炫耀約定戒指，\n而是偷偷戴上，看著戒指淺笑。
MID_FRIENDLIST_Misutira_TextD	【初期兵種】義警隊\n【生日】8月29日\n【備註】索爾姆王國第一公主。\n有玫琳、帕涅托涅兩名臣子。\n帶著「蒼炎勇者戒指」\n於綠洲短暫休息時，\n和來訪的神龍一行人\n聯手討伐盜賊後成為同伴。
MID_FRIENDLIST_Misutira_TextC	【喜歡的事物】\n肉、音樂、宴會、時尚、動物、\n露營、流浪、自由、\n和大家一起圍著營火\n【不喜歡的事物】\n打掃、童話故事、繁瑣的工作、\n被限制、拘束
MID_FRIENDLIST_Misutira_TextB	【興趣】唱歌、露營、流浪\n【專長】聲東擊西、引誘、生火\n【經歷】生為國家的第一公主，\n即便自幼接受女王應受的教育，\n性格仍愛好自由。總是不在城內，\n透過四處流浪掌握國內的狀況，\n以便國家有事時能及時制定對策。\n為了保衛國家也加入了自衛團。
MID_FRIENDLIST_Misutira_TextA	【身高】159cm\n【無名指的戒圍】10號\n【個性】無拘無束，平易近人。\n對任何人都很親切，也能自然地\n試探出對方的真心。喜歡唱歌，\n常突然唱起有點奇怪的自創曲。\n一旦被他認定為敵人便絕不寬恕。\n是軍中最常在晚上敲邦哥鼓的人。
MID_FRIENDLIST_Misutira_TextS	【成為搭檔後】\n即便可以經常兩人獨處，\n仍會保有幾天分開行動的自由生活。\n閒暇時兩人會坐在營火旁邊，\n聊起彼此最近遇到的事情。\n或許會被人誤解不常戴著約定戒指，\n其實他將戒指收在以金線編織的\n袋子中，每天小心翼翼地帶在身上。
MID_FRIENDLIST_Merin_TextD	【初期兵種】狼騎士\n【生日】9月24日\n【備註】索爾姆王國的王城騎士。\n和主子蜜絲提拉以及\n同袍帕涅托涅於綠洲短暫休息時，\n和來訪的神龍一行人\n聯手討伐盜賊後成為同伴。
MID_FRIENDLIST_Merin_TextC	【喜歡的事物】\n肉、武器、動物、音樂、\n帥氣的事物、珍禽異獸、甜食、\n蜜絲提拉唱的歌\n【不喜歡的事物】\n鬼故事、味道強烈的東西、失敗、\n對動物不友善的傢伙
MID_FRIENDLIST_Merin_TextB	【興趣】觀察、研究珍禽異獸\n【專長】正確說出動物的名稱與習性\n【經歷】來自索爾姆王國，\n沙漠村莊的村長之女。有兩名兄長，\n但索爾姆為女性當家的母系社會，\n自幼便以繼承人身分被教育成人。\n但玫琳無法放棄想成為騎士的夢想，\n毅然決然地離家後遇見了蜜絲提拉。
MID_FRIENDLIST_Merin_TextA	【身高】173cm\n【無名指的戒圍】11號\n【個性】全身散發華麗的氣息，\n不停追求帥氣的騎士。\n喜歡所有動物，特別是珍禽異獸，\n每當遇見動物時總是興奮到忘我。\n但似乎怕不帥氣而壓抑著衝動。\n是軍中最常把點心當作便當的人。
MID_FRIENDLIST_Merin_TextS	【成為搭檔後】\n兩人正仔細編寫神龍圖鑑，\n不論歡笑或是傷悲，\n會將所有事情都記錄在羊皮紙上。\n夢想未來要一起飼養動物。\n一拿起約定戒指就會忍不住傻笑，\n但實在太不帥氣了，因此不常戴。\n不過只要拜託他就會靦腆地戴上。
MID_FRIENDLIST_Panetone_TextD	【初期兵種】狂鬥士\n【生日】10月23日\n【備註】索爾姆王國的王城戰士。\n龐德羅的妹妹。\n和主子蜜絲提拉以及\n同袍玫琳於綠洲短暫休息時，\n和來訪的神龍一行人\n聯手討伐盜賊後成為同伴。
MID_FRIENDLIST_Panetone_TextC	【喜歡的事物】\n辣的食物、奇珍異味、蟲子、\n鬼故事、武器、妖怪、廢墟、\n陰暗處、蜜絲提拉的烤肉\n【不喜歡的事物】\n可愛的事物、下廚、花、打掃、\n繁文縟節、教會、莊嚴神聖的地方
MID_FRIENDLIST_Panetone_TextB	【興趣】漫步於危險的地方\n【專長】打架、近身戰、肉搏戰\n【經歷】來自索爾姆王國，\n生於綠洲之鄉的教會家庭。\n父母皆為神職人員，但因家庭環境\n不好，便拋下哥哥獨自離家出走。\n後來在到處惹事生非的生活之中，\n遇見了漂泊在外的蜜絲提拉。
MID_FRIENDLIST_Panetone_TextA	【身高】164cm\n【無名指的戒圍】11號\n【個性】用字遣詞過度客氣的淑女。\n雖然行為舉止非常有教養，\n但相當有個性，熱愛妖怪跟蟲子。\n曾有一段不堪的過往，\n有時會在戰鬥中不經意表露。\n是軍中最講道義的人。
MID_FRIENDLIST_Panetone_TextS	【成為搭檔後】\n為了在你面前常保端莊，\n行為舉止比以往來得更加高雅。\n他雖擔心自己的個性會導致爭吵，\n但兩人始終過得十分和睦。\n帕涅托涅將約定戒指收在他心愛的\n那個乍看有點不吉利的黑色盒子裡。\n除了戰鬥外都會好好地戴在手上。
MID_FRIENDLIST_Fogato_TextD	【初期兵種】義警隊\n【生日】2月14日\n【備註】索爾姆王國第一王子。\n有龐德羅、波聶兩名臣子。\n以自衛團團長身分，\n在出發準備討伐異形兵的路上\n遇到迷路的神龍一行人，\n主動表示自己可以幫忙引路。
MID_FRIENDLIST_Fogato_TextC	【喜歡的事物】\n肉、宴會、音樂、花、自然、\n熱帶水果、家族、同伴\n【不喜歡的事物】\n鬼故事、童話故事、薯類、\n釣魚、游泳、心思被看穿
MID_FRIENDLIST_Fogato_TextB	【興趣】聊天、搭訕他人\n【專長】偵察、隱藏身分\n【經歷】雖貴為第一王子，但索爾姆\n王國歷為女王制，因此與姊姊相比，\n從小更加自由。年幼時曾隨著父親\n在國內流浪，並學會如何隱蔽身分，\n這份經驗直到今日仍受用，現在則\n為了保護國家成為自衛團的一分子。
MID_FRIENDLIST_Fogato_TextA	【身高】178cm\n【無名指的戒圍】18號\n【個性】個性開朗且不拘小節，\n能輕易成功搭訕任何他感興趣的人。\n非常喜歡宴會與歡樂的事物。\n除了有較輕浮、親切的一面之外，\n也擅於刺探他人真意，不容小覷。\n是軍中最能直接表達感情的人。
MID_FRIENDLIST_Fogato_TextS	【成為搭檔後】\n每次遇見你都會說「超喜歡你」，\n但這句話的含意已經不同以往了。\n由於他表達愛意的方式過於熱情，\n害得一旁的同伴們看了也不好意思。\n幾乎隨時戴著約定戒指，\n每次戰鬥前都會親吻戒指上的寶石，\n祈禱兩人能夠平安歸來。
MID_FRIENDLIST_Pandoro_TextD	【初期兵種】主教\n【生日】1月6日\n【備註】索爾姆王國的王城神官。\n與同袍波聶正在討伐出現於\n圖拉沙漠的異形兵時，\n主子佛賈特前來支援。\n即使自己信仰的神龍也一同出現\n而深感惶恐，依然加入了神龍軍。
MID_FRIENDLIST_Pandoro_TextC	【喜歡的事物】\n神龍、宴會、音樂、玩耍、\n童話故事、乳製品、歌唱、\n合群的信徒\n【不喜歡的事物】\n運動、鍛鍊、特辣的食物、跳舞、\n拒絕接受新事物的人
MID_FRIENDLIST_Pandoro_TextB	【興趣】宴會、狂歡\n【專長】唱歌、熬夜、傾聽煩惱\n【經歷】來自索爾姆王國，\n生於綠洲之鄉的教會家庭。\n父母皆為神職人員，但因家庭\n環境不好，妹妹憤而離家出走。\n他勉力支撐教會之際，因緣際會\n結識了佛賈特，受邀成為家臣。
MID_FRIENDLIST_Pandoro_TextA	【身高】175cm\n【無名指的戒圍】14號\n【個性】非常喜歡開心的事。\n經常構思新的宴會主題。\n雖然常被人誤以為他不夠正經，\n但絕對是名虔敬且真誠的神職人員。\n尤其對神龍更是忠貞不二。\n是軍中聲音最響亮的人。
MID_FRIENDLIST_Pandoro_TextS	【成為搭檔後】\n一開始雖有顧忌又過於客氣，\n但現在對你展現的笑容\n已經不像是在看著信仰對象了。\n對你的感情不像在宴會上那樣浮誇，\n而是會靜靜地思念著你。\n把約定戒指像聖物一樣供在房裡的\n小型祭壇上，每天對著戒指祈禱。
MID_FRIENDLIST_Bonet_TextD	【初期兵種】英勇騎士\n【生日】5月30日\n【備註】索爾姆王國的宮廷御廚。\n與同袍龐德羅在討伐出現於\n圖拉沙漠的異形兵時，\n主子佛賈特前來加入支援。\n此後順勢加入神龍軍。
MID_FRIENDLIST_Bonet_TextC	【喜歡的事物】\n下廚、茶會、香草、花、\n所有的食材、所有看起來美味的物質\n【不喜歡的事物】\n味道強烈的東西、曬太陽、鍛鍊、\n吵雜的地方、光線刺眼的地方、\n重口味的食物
MID_FRIENDLIST_Bonet_TextB	【興趣】嘗試味道、園藝\n【專長】完美重現嘗過味道的料理\n【經歷】來自索爾姆王國。\n獨生子，家中於商港城市經營餐廳。\n餐廳頗具盛名，卻因遭盜賊襲擊\n而毀於一旦。多年後，波聶參加了\n宮廷御廚選拔賽，雖未獲得優勝，\n但收到佛賈特邀約，成為其家臣。
MID_FRIENDLIST_Bonet_TextA	【身高】184cm\n【無名指的戒圍】20號\n【個性】熱心研究且忠於自我。\n不時在找尋新的料理食材。\n就算不是食物，只要他覺得看起來\n美味的事物，都會想要嘗嘗味道。\n不僅是味覺，所有感官都相當敏銳。\n是軍中研究旗幟學最透徹的人。
MID_FRIENDLIST_Bonet_TextS	【成為搭檔後】\n依兩人相處的日常生活為基礎，\n研發許多新料理而感到無比幸福。\n閒暇之餘兩人會一起照顧菜園，\n品嘗滋味甜美的閒話家常時光。\n將約定戒指放在像是銀製餐具的\n盒子裡，並且放入了花與香草。\n其實偷偷品嘗過戒指寶石的味道。
MID_FRIENDLIST_Anna_TextD	【初期兵種】斧戰士\n【生日】6月8日\n【備註】實習旅行商人。\n為了尋找能高價販售的寶物\n而潛入盜賊團根據地時，\n恰巧遇到神龍軍與盜賊交戰，\n因此躲進寶箱裡面避難。\n被發現後加入神龍軍成為同伴。
MID_FRIENDLIST_Anna_TextC	【喜歡的事物】\n乳製品、高級品、工藝、裁縫、\n下廚、慶典、雪、生意興隆\n【不喜歡的事物】\n鬼故事、蟲子、特辣的食物、\n堅硬的食物、夢到家人的早晨
MID_FRIENDLIST_Anna_TextB	【興趣】構思、開發全新商品\n【專長】記帳、砍柴\n【經歷】來自伊爾席翁王國，\n生於秘境內的冬祭之村。\n村內的族人皆為旅行商人，並有著\n許多長相、名字都相同的姊妹。\n在行商途中不小心與家族走散，\n只能靠自己勉強維持生計。
MID_FRIENDLIST_Anna_TextA	【身高】142cm\n【無名指的戒圍】3號\n【個性】腦袋靈光的守財奴。\n一抓到機會就推銷自己的商品，\n但若銷售不佳馬上就會淚眼汪汪。\n非常喜歡慶典，即使只是小確幸，\n都會當成是紀念日一樣大肆慶祝。\n是軍中有著最多紀念日的人。
MID_FRIENDLIST_Anna_TextS	【成為搭檔後】\n兩人總是融洽地討論新商品的\n企劃，夢想著下次一定會發大財。\n將成為搭檔的那一天\n訂為比生日更重要的紀念日，\n並約好每年都要兩人一起慶祝。\n由於約定戒指的尺寸略大，\n將戒指套在繩子上當作項鍊配戴。
MID_FRIENDLIST_Jean_TextD	【初期兵種】僧侶\n【生日】3月31日\n【備註】費列聶王國的平民。\n當茶園之鄉遭異形兵侵襲時，\n他正在父親的診所與之奮戰。\n在趕來救援的神龍軍幫助下，成功\n擊退異形兵後，他雖才初出茅廬，\n仍志願加入神龍軍成了隨軍醫師。
MID_FRIENDLIST_Jean_TextC	【喜歡的事物】\n茶會、學習、閱讀、動物、\n看起來健康的人、稀有的藥草、\n產自故鄉的茶\n【不喜歡的事物】\n運動、鍛鍊、宴會、奇珍異味、\n受傷、生病、自身技術不足
MID_FRIENDLIST_Jean_TextB	【興趣】閱讀圖鑑\n【專長】調配藥品、泡茶\n【經歷】來自費列聶王國，\n生於茶園之鄉裡的一間診所。\n父親是醫生，母親則是茶農。\n有位年紀差距較大，並留在\n費列聶王國內擔任醫生的姊姊。\n賈恩企盼自己終有天能繼承家業。
MID_FRIENDLIST_Jean_TextA	【身高】140cm\n【無名指的戒圍】4號\n【個性】雖內向但相當體貼。\n為實現夢想而不停鑽研的拼命三郎。\n雖然年幼卻完全不害怕鬼怪，\n反而覺得受傷或生病比較可怕。\n較活潑的說話口氣是島上的特色。\n是軍中最擅長剪頭髮的人。
MID_FRIENDLIST_Jean_TextS	【成為搭檔後】\n正如賈恩收到戒指後所言，\n他隨時都在身後扶持著你。\n每當兩人一起去採藥草，都會摘下\n一朵花夾在醫書中當作壓花紀念。\n將約定戒指放進美麗的玻璃瓶裡，\n期待自己有朝一日能夠成為\n配得上這只戒指的有志青年。
MID_FRIENDLIST_Yunaka_TextD	【初期兵種】小偷\n【生日】7月28日\n【備註】神出鬼沒的盜賊。\n與神龍一行人在費列聶郊外相遇，\n為了奪回「拂曉巫女戒指」，\n在廢棄村莊一同戰鬥。戰鬥結束後，\n坦承自己就是竊走戒指的犯人。\n此後加入神龍軍成為同伴。
MID_FRIENDLIST_Yunaka_TextC	【喜歡的事物】\n武器、閱讀、音樂、鍛鍊、毒物、\n在黑暗中執行任務、視線不良的地方\n【不喜歡的事物】\n童話故事、宴會、動物、家事、\n打探、味道強烈的東西、\n暴露自己的長相
MID_FRIENDLIST_Yunaka_TextB	【興趣】待在隱密的地方\n【專長】模仿、保養武器\n【經歷】來自布羅帝亞王國。\n宣稱自幼父母雙亡，\n但是否屬實則無從得知。\n為了揮別過去、活出新的自我，\n離開祖國踏上了旅途。
MID_FRIENDLIST_Yunaka_TextA	【身高】164cm\n【無名指的戒圍】9號\n【個性】活潑好動、與人相處融洽。\n演技相當出色，\n擅於模仿同伴或是動物的叫聲。\n在戰鬥中彷彿換了一個人似的，\n會散發與日常不同的氛圍。\n在軍中是最會分辨真偽的人。
MID_FRIENDLIST_Yunaka_TextS	【成為搭檔後】\n對你已不需要再有任何隱瞞，\n能夠展現最真實的笑容。\n兩人獨處時會像在回想一般，\n一一地向你傾訴自己的往事。\n將約定戒指收在靠正當手段努力\n賺來的錢所買的金製小盒中保管，\n將戒指看得比自己的性命還重要。
MID_FRIENDLIST_Seadas_TextD	【初期兵種】舞蹈家\n【生日】4月21日\n【備註】索爾姆王國的舞者。\n當他在北城塞練習舞蹈時，\n不巧遭遇了異形兵襲擊。此時，\n他聽到自「選擇未來之人戒指」\n傳出來的聲音，指引他躲進城塞中。\n此後獲神龍軍援救並加入成為同伴。
MID_FRIENDLIST_Seadas_TextC	【喜歡的事物】\n音樂、肉、時尚、閱讀、香草、\n星星、月亮、甜食、高脂肪食物、\n幻想自己沒去過的地方\n【不喜歡的事物】\n鍛鍊、曬太陽、早起、苦的食物、\n忍耐、吃太撐的隔日清早
MID_FRIENDLIST_Seadas_TextB	【興趣】眺望未知的城鎮\n【專長】舞蹈、占卜、暴飲暴食\n【經歷】來自索爾姆王國，\n生於風光明媚的紺碧海岸。\n出生時父親已辭世，身為占卜師的\n母親也早逝，因而被商隊收留。\n拜師學成舞蹈後便自食其力，\n現在已是知名的舞蹈家。
MID_FRIENDLIST_Seadas_TextA	【身高】177cm\n【無名指的戒圍】13號\n【個性】華麗、充滿魅力之人。\n全身散發神秘氣息，說話有點毒，\n但是對於中意的對象則分外溫柔。\n非常注重外在，卻也非常嗜吃，\n每天都為了進食與否而十分糾結。\n是軍中最喜歡蜂蜜的人。
MID_FRIENDLIST_Seadas_TextS	【成為搭檔後】\n每一個星光燦爛的夜晚，\n都會兩人一起望著星空談心。\n只要和你在一起就會心滿意足，\n因此每當肚子餓時都會跑來找你，\n並且不願離去。將約定戒指放在以\n金線刺繡的天鵝絨袋中，只有表演\n特別舞蹈時才會將戒指戴在手上。
MID_FRIENDLIST_Linden_TextD	【初期兵種】聖者\n【生日】6月29日\n【備註】伊爾席翁王國的王城士兵。\n起初雖為了阻止神龍等人的船隊\n從費列聶進入伊爾席翁而挑起戰鬥，\n但其實心中有著自己的考量。\n被說服後加入神龍軍成為同伴。
MID_FRIENDLIST_Linden_TextC	【喜歡的事物】\n散步、工藝、閱讀、學習、下廚、\n薯類、實驗、魔道書、有意思的發展\n【不喜歡的事物】\n武器、打掃、激烈運動、\n實驗失敗、收拾爆炸後的殘局
MID_FRIENDLIST_Linden_TextB	【興趣】實驗、和年輕人交流\n【專長】利用魔法製作點心\n【經歷】來自伊爾席翁王國出身。\n生於知識之塔附近的村莊。\n年輕時隸屬海亞信斯王兄長麾下，\n是一名優秀的王城士兵。\n已婚，但妻子已經離世，\n三個小孩也都已各自獨立。
MID_FRIENDLIST_Linden_TextA	【身高】175cm\n【無名指的戒圍】19號\n【個性】擁有龐大魔力的賢者。\n求知慾旺盛，平常總喜歡讀書，\n或者是做一些奇怪的實驗。\n拿手料理是以雷電魔法\n慢慢烘烤出的蛋糕與餅乾。\n是軍中最會釋放靜電的人。
MID_FRIENDLIST_Linden_TextS	【成為搭檔後】\n兩人就像和睦融洽的親子一樣，\n總是充滿歡笑地一起做實驗。\n他表示花心思照顧你這位搭檔，\n已成了他餘生最大的生存意義。\n將約定戒指放在胸前的墜飾中，\n打算等到未來你即位的那一天，\n再將戒指戴在自己的手上。
MID_FRIENDLIST_Saphir_TextD	【初期兵種】勇士\n【誕生日】1月17日\n【備註】布羅帝亞王國的王城士兵。\n為了向順利登陸伊爾席翁的神龍軍\n傳達布羅帝亞城平安無事的消息，\n隻身奔往吉布爾港。\n在戰鬥中順利與神龍軍會合後，\n加入神龍麾下一同並肩作戰。
MID_FRIENDLIST_Saphir_TextC	【喜歡的事物】\n魚、鍛鍊、釣魚、武器、宴會、\n薯類、乳製品、喧囂的夜晚\n【不喜歡的事物】\n繁瑣的工作、時尚、可愛的東西、\n高級品、看起來嬌滴滴的人、\n伊爾席翁兵
MID_FRIENDLIST_Saphir_TextB	【興趣】交手\n【專長】處理魚類、游泳\n【經歷】來自布羅帝亞王國，\n生於鄉下的漁村。年紀尚幼時，\n父母遭到經海路入侵的\n伊爾席翁兵襲擊而不幸殞命。\n自此成為傭兵，征戰各地。\n爾後獲得賞識，成為王城士兵。
MID_FRIENDLIST_Saphir_TextA	【身高】177cm\n【無名指的戒圍】14號\n【個性】勇猛且意志堅定。\n有著力求不斷提升自我的特質，\n喜歡鍛鍊、和強者比試。\n個性大而化之，但很會照顧人，\n常帶頭傾聽青年後進的煩惱。\n是軍中最熟悉魚類知識的人。
MID_FRIENDLIST_Saphir_TextS	【成為搭檔後】\n兩人在一場場鍛鍊與比試中，\n彼此心神交流情誼越漸深重。\n偶爾也會特地為了你下廚，\n用拿手的魚料理表達情意。\n雖然覺得戴戒指不合形象，\n因此並不常戴上約定戒指。\n但出兵時定會藏在鎧甲中。
MID_FRIENDLIST_Veyre_TextD	【初期兵種】邪龍之女\n【誕生日】9月12日\n【備註】邪龍尚卜爾的女兒。\n神龍\x0E\x06\x03\x00唯一的妹妹。\n雙方雖曾因尚卜爾的奸計而敵對，\n但最後貝珥憑著自己的意志戰勝了\n邪惡人格。後為了成為救世之龍，\n決定跟隨在神龍身邊，一同奮戰。
MID_FRIENDLIST_Veyre_TextC	【喜歡的事物】\n特辣的食物、散步、閱讀、花、\n玩耍、燭光、兄弟姊妹\n【不喜歡的事物】\n高級品、味道強烈的東西、惡夢、\n甜食、明亮的地方
MID_FRIENDLIST_Veyre_TextB	【興趣】幫助他人、和同伴交流\n【專長】製作精巧的異形兵\n【經歷】生於古拉鐸隆之地，\n為邪龍諸子的么女。\n母親是心地善良的魔龍族。\n即便歷經千年的孤獨、甚至被父親\n當作棋子，在非自願的情況下戰鬥，\n卻從未失去自己善良的心。
MID_FRIENDLIST_Veyre_TextA	【身高】158cm\n【無名指的戒圍】5號\n【個性】善良且純真。\n總是優先考慮他人心情的大好人。\n盼望自己可以幫助他人，\n對有難的人無法坐視不管。\n為人很客氣，但非常喜歡玩耍。\n是軍中最能忍耐疼痛的人。
MID_FRIENDLIST_Veyre_TextS	【成為搭檔後】\n兩人一起四處助人、一起挑戰\n特辣的食物，過著融洽的生活。\n兩人也建立起了即使分隔兩地\n也能心有靈犀的神奇連繫。\n將約定戒指當作最重要的護身符，\n將戒指用以前保護你交付之龍石的\n那塊神聖布料包覆著並隨身攜帶。
MID_FRIENDLIST_Mauve_TextD	【初期兵種】皇家騎士\n【生日】9月13日\n【備註】保護貝珥的騎士。\n過去曾以四狗成員身分與神龍軍\n敵對，但因為尚卜爾與賽皮雅\n違背道義的行為而選擇叛變。\n為了替同袍復仇，也為了主子貝珥，\n加入神龍陣營。
MID_FRIENDLIST_Mauve_TextC	【喜歡的事物】\n特辣的食物、鍛鍊、工藝、武器、\n肉、花、田園風光、酥皮餡餅\n【不喜歡的事物】\n玩耍、宴會、高級品、時尚、\n隱密行動、不合情理的行為
MID_FRIENDLIST_Mauve_TextB	【興趣】幫助他人、傾聽\n【專長】不眠不休地日夜巡視\n【經歷】來自費列聶王國。\n莫布為有錢人家的獨生子，但父親\n過世後，母親抑鬱成疾，帶著他\n投奔伊爾席翁王國，成為邪龍信徒。\n在隱藏的神殿裡遇見了貝珥，\n邪龍復活後，以四狗的身分侍奉他。
MID_FRIENDLIST_Mauve_TextA	【身高】195cm\n【無名指的戒圍】24號\n【個性】剛毅木訥的習武之人。\n雖然常因沉默寡言而招致誤解，\n實際上個性善良且樂於保護弱勢。\n總是認真執行任務，不太懂得\n如何休息，所有娛樂都與他無緣。\n是軍中最難受到催眠影響的人。
MID_FRIENDLIST_Mauve_TextS	【成為搭檔後】\n並不打算將你占為己有，但只要在\n他的視線範圍內定會竭力保護你。\n兩人獨處時更是格外地溫柔，\n將你當作寶物般捧在手心呵護。\n他將約定戒指保管在自己手邊\n不常見的雕琢精細花紋的小盒中，\n每天都會一絲不苟地細心保養。
MID_FRIENDLIST_Mascot_TextD	【相遇的日子】\x0E\x01\x00\x00月\x0E\x01\x01\x00日\n【大小】約等於蓬鬆的麵包\n【重量】兩顆蜜桃重\n【備註】索拉涅爾的守護神。\n待在洞穴裡的祭壇上。\n一見到\x0E\x06\x03\x00\n便會興奮地追上去。\n與琉彌艾爾相識許久。
MID_FRIENDLIST_Mascot_TextA	【個性】\n溫和、樂觀\n【喜歡的事物】\n\x0E\x06\x03\x00、蝴蝶、\n柔軟的東西、溫暖的東西、\n第一次品嘗的食物\n【不喜歡的事物】\n身邊的人離開自己
