MID_FRIENDLIST_El_TextD	【初期兵種】邪龍之女\n【生日】2月24日\n【備註】異世界的尚卜爾之子嗣。\n在異世界裡隸屬神龍的麾下。\n於蒐集七手鐲的戰役中，\n為拯救弟弟而犧牲，陷入千年沉眠。\n藉由拉法爾的力量甦醒後，\n來到這世界的索拉涅爾並成為同伴。
MID_FRIENDLIST_El_TextC	【喜歡的事物】\n神龍、花、特辣的食物、奇珍異味、\n動物、武器、自然、安靜的地方、\n湛藍的天空\n【不喜歡的事物】\n下廚、釣魚、時尚、童話故事、\n味道強烈的東西、神龍的睡相
MID_FRIENDLIST_El_TextB	【興趣】在一旁觀察人類\n【專長】夜間視力、心算\n【經歷】生為異世界的邪龍子嗣，\n自幼便十分優秀，受其他手足景仰，\n但為了保護弟弟，加入神龍軍。\n將不為人知的思念，\n寄託於不同世界的神龍身上。
MID_FRIENDLIST_El_TextA	【身高】175cm\n【無名指的戒圍】10號\n【個性】不會過度表露情緒，\n沉著冷靜，能夠簡潔傳達事物。\n看似對神龍特別地嚴苛，\n實際上卻是時時刻刻為神龍著想。\n一旦認定為夥伴就會付出真心。\n是軍中最會唱搖籃曲的人。
MID_FRIENDLIST_El_TextS	【成為搭檔後】\n偶爾還是會表現出尖銳的一面，\n但不論何時都想陪在你的身邊，\n就算短暫分離也會無比寂寞。\n他聲稱將約定戒指放在房裡，\n不過那只是因為害羞才這樣說，\n其實他隨時帶著戒指，從不離身。
MID_FRIENDLIST_Rafale_TextD	【初期兵種】邪龍之子\n【生日】12月31日\n【備註】異世界的尚卜爾之子嗣。\n在異世界的戰役中欺騙了同伴，\n以邪龍繼承人自居並與我方為敵，\n但在姊姊犧牲後恢復理智。\n將自己的力量分給愛爾後，\n來到這世界的索拉涅爾並成為同伴。
MID_FRIENDLIST_Rafale_TextC	【喜歡的事物】\n甜食、薯類、自然、鬼故事、宴會、\n高級品、閱讀、畏懼的眼神、\n外型如寶石般的點心\n【不喜歡的事物】\n運動、鍛鍊、曬太陽、工作、打掃、\n被人小看、別人的好意
MID_FRIENDLIST_Rafale_TextB	【興趣】發掘甜點店\n【專長】震懾他人、趕跑動物\n【經歷】生為異世界的邪龍子嗣。\n自幼起便開始假扮成\n愛爾的孿生手足「伊爾」。\n爭奪七手鐲的戰役結束後，\n重拾自己的本名「拉法爾」，\n告別長久以來的偽裝生涯。
MID_FRIENDLIST_Rafale_TextA	【身高】176cm\n【無名指的戒圍】14號\n【個性】驕矜自大、以自我為中心。\n對欣賞的人會表現強烈獨占欲。\n在異世界經過千年時光，\n殘虐的性格已被磨平，\n並理解何謂關懷以及同理心。\n是軍中氣場最可怕的人。
MID_FRIENDLIST_Rafale_TextS	【成為搭檔後】\n雖然因為害羞而無法坦率說出口，\n但其實十分重視你的一切。\n嫉妒心重，只要你和他人獨處，\n就會從遠方投以震懾力十足的眼神。\n他將約定戒指珍藏在以自身鱗片\n製成的容器中，其他人別說想碰，\n甚至無法瞧上一眼。
MID_FRIENDLIST_Selestia_TextD	【初期兵種】美露莘\n【生日】11月21日\n【備註】存活數千年的魔龍族。\n在異世界為「四翼」之首領，\n為守護愛爾和拉法爾而戰。\n戰爭結束後下定決心，\n答應神龍的邀請，\n來到這世界並成為同伴。
MID_FRIENDLIST_Selestia_TextC	【喜歡的事物】\n音樂、動物、散步、玩耍、蔬菜、\n可愛的事物、小巧的事物、長髮、\n被人依賴\n【不喜歡的事物】\n鬼故事、乳製品、肉、繁瑣的工作、\n閱讀、壞天氣、炎熱的地方
MID_FRIENDLIST_Selestia_TextB	【興趣】聊天、照顧龍\n【專長】察覺情緒的細微變化\n【經歷】來自異世界的魔龍族村莊。\n由於與生俱來的魔力低落，\n因此在邪龍尚卜爾撲殺魔龍族時\n逃過一劫，是唯一的生還者。\n逃到里特司之地後得到庇護，\n自此加入神龍陣營，為神龍而戰。
MID_FRIENDLIST_Selestia_TextA	【身高】180cm\n【無名指的戒圍】13號\n【個性】天真開朗，\n喜歡關懷周遭的人。\n雖然情感豐富、喜怒分明，\n但善於察言觀色，不會破壞和諧。\n比起自己，更常顧慮別人的感受。\n是軍中最喜歡曬日光浴的人。
MID_FRIENDLIST_Selestia_TextS	【成為搭檔後】\n與你相親相愛，度過幸福的每一天。\n每次用餐時必定會餵彼此吃\n自己覺得美味的料理。\n將約定戒指收在以前琉彌艾爾\n贈送的小盒子裡，每天睡前都會\n向戒指訴說和你發生的大小事。
MID_FRIENDLIST_Gregory_TextD	【初期兵種】聖者\n【生日】9月17日\n【備註】「四翼」的一員。\n在異世界的戰役中，\n因莫布戰死而接任四翼的副官。\n戰爭結束後下定決心，\n答應神龍的邀請，\n來到這世界並成為同伴。
MID_FRIENDLIST_Gregory_TextC	【喜歡的事物】\n花、自然、裁縫、動物、釣魚、\n工藝、摸起來軟綿綿的東西、\n原料溫和的衣服與食物\n【不喜歡的事物】\n特辣的食物、鬼故事、武器、\n鍛鍊、奇珍異味、蟲、疼痛、\n氣候極端的地方
MID_FRIENDLIST_Gregory_TextB	【興趣】裹著毛毯度日\n【專長】製作服裝、製作派\n【經歷】來自異世界的伊爾席翁，\n在貧窮家庭的家暴陰影中成長。\n被賣給人口販子後，開始浪跡天涯。\n輾轉寄身於信仰邪龍的教會，\n但因害怕獻血等儀式而逃走。\n在賽勒斯提雅的邀請下加入神龍軍。
MID_FRIENDLIST_Gregory_TextA	【身高】177cm\n【無名指的戒圍】17號\n【個性】重情重義的隨和大哥哥。\n討厭疼痛和恐怖的事，渴望和平。\n相當謹慎，為了避免麻煩，\n事前會做好萬全的策畫，\n但也有過於溫柔而難拒絕人的一面。\n是軍中擁有最多玩偶的人。
MID_FRIENDLIST_Gregory_TextS	【成為搭檔後】\n為了療癒疲於奔命的你，\n每天會在房間泡好茶等你回來。\n另外也會親手製作派來當作茶點，\n那柔順的滋味是你們之間的秘密。\n因為害怕傷到約定戒指，\n便放在鋪滿軟墊的小盒子中，\n每次撫摸戒指時一定會戴上手套。
MID_FRIENDLIST_Madeline_TextD	【初期兵種】將軍\n【生日】4月4日\n【備註】「四翼」的一員。\n在異世界的戰役中\n負責偵察伊爾席翁，幫助了夥伴。\n戰爭結束後下定決心，\n答應神龍的邀請，\n來到這世界並成為同伴。
MID_FRIENDLIST_Madeline_TextC	【喜歡的事物】\n鍛鍊、運動、學習、帥氣的事物、\n茶、大人口味的食物、\n黃昏時的天空、有彩虹的風景\n【不喜歡的事物】\n蟲、下廚、打掃、裁縫、\n陰暗的神殿、稱讚、\n味道強烈的東西、鋒利的刀具
MID_FRIENDLIST_Madeline_TextB	【興趣】蒐集有蝴蝶結的物品\n【專長】熟記地圖及各種平面圖\n【經歷】來自異世界的伊爾席翁。\n出生於騎士世家，但邪龍復活時\n爆發戰爭，雙親在戰中相繼過世。\n堅守最後一座城鎮時遭異形兵襲擊，\n於千鈞一髮之際得到莫布的援救，\n並被他帶往里特司之地。
MID_FRIENDLIST_Madeline_TextA	【身高】162cm\n【無名指的戒圍】7號\n【個性】理性且正經。\n擅長自我肯定，相當沉穩。\n經常看見別人的優點並給予稱讚，\n但認為自己不需要他人的讚賞。\n夢想是成為和父母一樣的騎士。\n是軍中最常仰望天空的人。
MID_FRIENDLIST_Madeline_TextS	【成為搭檔後】\n在眾人面前仍然展現騎士的尊嚴，\n但兩人獨處時便會卸下防備，\n適時地依賴你。\n每天會在鍛鍊結束後，\n和你互相分享一天發生的事。\n將約定戒指放在他最愛的\n紅色蝴蝶結小盒子裡。
