MID_TUT_CATEGORY_TITLE_Battle	戰鬥
MID_TUT_CATEGORY_TITLE_God	紋章士
MID_TUT_CATEGORY_TITLE_Hub	據點
MID_TUT_CATEGORY_TITLE_Kizuna	散步・世界地圖
MID_TUT_CATEGORY_TITLE_Challenge	試煉
MID_TUT_CATEGORY_TITLE_Local	小提示
MID_TUT_BMAP_MOVE_TITLE	移動
MID_TUT_BMAP_MOVE_0	將游標對準我方單位並按下\x0E\x08\x02\x04\x02A鍵，\n即可用\x0E\x08\x02\x0E\x0CStickL來移動單位。
MID_TUT_BMAP_MOVE_1	顯示的「藍色格子」為可移動範圍。
MID_TUT_BMAP_MOVE_2	再次按下\x0E\x08\x02\x04\x02A鍵即移動完成。
MID_TUT_BMAP_COMMAND_TITLE	單位指令
MID_TUT_BMAP_COMMAND_0	移動完成後會顯示「單位指令」，\n可選擇能在該處執行的行動。
MID_TUT_BMAP_COMMAND_1	什麼都不做時，\n就在該處選擇「待命」。
MID_TUT_BMAP_CHANGE_TITLE	切換行動階段
MID_TUT_BMAP_CHANGE_0	當所有我方單位的行動結束後，\n將切換成敵軍的行動階段，\n敵方單位會開始行動。
MID_TUT_BMAP_CHANGE_1	我軍行動階段起始至\n敵軍行動階段結束稱為「回合」，\n「回合」結束後便會再從我軍行動階段開始。
MID_TUT_BMAP_ATTACK_TITLE	攻擊
MID_TUT_BMAP_ATTACK_0	讓我方移動到敵人附近按下\x0E\x08\x02\x04\x02A鍵，\n並從單位指令中選擇「攻擊」。
MID_TUT_BMAP_ATTACK_1	將游標對準敵人，出現「\x0E\x08\x02\x04\x02A攻擊」後\n就可用\x0E\x08\x02\x04\x02A鍵展開攻擊。
MID_TUT_BMAP_ENGAGE_TITLE	結合
MID_TUT_BMAP_ENGAGE_0	結合計量條達到上限時，\n可從「單位指令」中選擇「結合」。
MID_TUT_BMAP_ENGAGE_1	若選擇「結合」，\n將會進入和紋章士一心同體的狀態，\n變得可使用「結合武器」這種特殊武器。
MID_TUT_BMAP_ENGAGE_2	此外，還能透過解放「結合特技」，\n強化我方的能力。
MID_TUT_BMAP_ENGAGE_3	「結合」狀態可持續3回合。
MID_TUT_BMAP_ENGAGE_ATTACK_TITLE	結合技
MID_TUT_BMAP_ENGAGE_ATTACK_0	進入結合狀態時，\n可使用「結合技」這種特殊的特技。
MID_TUT_BMAP_ENGAGE_ATTACK_1	雖然每次結合時只能使用一次「結合技」，\n但這是一種非常強大的能力。
MID_TUT_BMAP_ENGAGE_ATTACK_2	例如結合技「星之突擊」可對敵人造成大量傷害，\n只要選擇「星之突擊」和「武器」即可使用。
MID_TUT_BMAP_TERRAIN_TITLE	地形效果
MID_TUT_BMAP_TERRAIN_0	地形會有各式各樣的「地形效果」。\n例如在「草叢」裡敵人的攻擊就不容易命中。
MID_TUT_BMAP_TERRAIN_1	但要注意的是，進入「草叢」\n要消耗比平常更多的移動力。
MID_TUT_BMAP_TERRAIN_2	「地形效果」可以在畫面\n左上方的「地形資訊」查看。\n妥善運用在戰鬥上吧。
MID_TUT_BMAP_RECOVERY_TITLE	回復
MID_TUT_BMAP_RECOVERY_0	HP歸零將無法戰鬥，\n在那之前使用傷藥「回復」HP吧。
MID_TUT_BMAP_RECOVERY_1	玩家可從單位指令的「持有物品」中\n選擇「傷藥」→「使用」來回復HP。
MID_TUT_BMAP_SYNCHRO_TITLE	同步
MID_TUT_BMAP_SYNCHRO_0	單位和紋章士一同踏上戰場，\n並肩作戰的狀態稱為「同步」。
MID_TUT_BMAP_SYNCHRO_1	「同步」時能力會上升，\n並解放特殊的特技。
MID_TUT_BMAP_KIZUNA_LV_TITLE	牽絆等級
MID_TUT_BMAP_KIZUNA_LV_0	我方與紋章士並肩作戰時會累積\n彼此之間的「牽絆經驗值」，\n提高「牽絆等級」。
MID_TUT_BMAP_KIZUNA_LV_1	「牽絆等級」提升後，\n可習得新的特技\n或提升單位的各種能力。
MID_TUT_BMAP_RANGE_TITLE	射程
MID_TUT_BMAP_RANGE_0	每種武器都擁有各自的「射程」。\n例如弓箭為「射程2」，\n可攻擊2格遠的敵人。
MID_TUT_BMAP_RANGE_1	雖然不會遭到武器射程1的敵人反擊，\n但也無法攻擊或反擊與自身相鄰的敵人。
MID_TUT_BMAP_BREAK_TITLE	打破
MID_TUT_BMAP_BREAK_0	裝備「互克上占優勢的武器」後，\n只要主動攻擊並命中敵人，\n就可使對方陷入「打破」狀態。
MID_TUT_BMAP_BREAK_1	敵人陷入「打破」狀態後，\n在下次戰鬥前將無法反擊，\n可趁此時將戰況導向我方。
MID_TUT_BMAP_BREAK_2	武器互克如下：\n・劍強於斧、斧強於槍、槍強於劍\n・體術強於弓、魔道書和短劍
MID_TUT_BMAP_WAND_TITLE	杖
MID_TUT_BMAP_WAND_0	僧侶等人可使用的「杖」\n擁有多種效果，可用來輔助夥伴。
MID_TUT_BMAP_WAND_1	例如「聖療」可回復我方單位的HP。
MID_TUT_BMAP_WAND_2	雖然很實用，但要小心\n杖有使用次數上的限制。
MID_TUT_STYLE_PRANA_TITLE	戰鬥類型【氣功】
MID_TUT_STYLE_PRANA_0	戰鬥類型為【氣功】的單位\n可使用「連鎖防禦」\n保護與自身相鄰的我方單位免於敵人的攻擊。
MID_TUT_STYLE_PRANA_1	發動後，保護者最多會受到HP20%的傷害，\n讓受保護的我方單位傷害為0。
MID_TUT_STYLE_PRANA_2	「連鎖防禦」只能在自身HP全滿時使用。\n（HP稍有減少便無法使用）
MID_TUT_BMAP_MAGIC_TITLE	魔法
MID_TUT_BMAP_MAGIC_0	「魔法」的射程較遠，\n還可以攻擊相鄰的敵人。
MID_TUT_BMAP_MAGIC_1	另外，對較難以劍、斧等\n物理攻擊傷害的敵人非常有效。
MID_TUT_STYLE_MAGIC_TITLE	戰鬥類型【魔道】
MID_TUT_STYLE_MAGIC_0	戰鬥類型為【魔道】的單位以魔法攻擊時，\n會使敵人因地形效果獲得的回避+補正無效。
MID_TUT_STYLE_MAGIC_1	即便是平常很難命中的\n情況也不用擔心，\n該類型可從遠方加以攻擊。
MID_TUT_BMAP_GOD_ENERGY_TITLE	紋章氣
MID_TUT_BMAP_GOD_ENERGY_0	地圖上會滯留\n一種稱為「紋章氣」的能量。
MID_TUT_BMAP_GOD_ENERGY_1	同步時的我方單位\n若在「紋章氣」上結束行動或待命，\n結合計量條將會累積至上限。
MID_TUT_OVERALLINFORMATION_TITLE	危險範圍
MID_TUT_OVERALLINFORMATION_0	把游標瞄準敵人後，就會顯示代表該敵人\n攻擊範圍的「危險範圍」。只要按下\x0E\x08\x02\x04\x02A鍵，\n就能讓選取的敵人一直顯示「危險範圍」。
MID_TUT_OVERALLINFORMATION_1	\x0E\x08\x02\x06\x04ZL鍵可一次顯示所有敵人的「危險範圍」。
MID_TUT_BMAP_SPECIALATTACK_TITLE	克制
MID_TUT_BMAP_SPECIALATTACK_0	武器詳細資訊上的「克制圖示」\n代表該武器可「克制」特定的敵人。
MID_TUT_BMAP_SPECIALATTACK_1	攻擊武器資訊上克制圖示標示的敵人，\n就會產生「克制」效果，\n可造成比平常更多的傷害。
MID_TUT_STYLE_COOP_TITLE	戰鬥類型【連攜】
MID_TUT_STYLE_COOP_0	戰鬥類型為【連攜】的單位\n會在我方其他單位攻擊時\n使用「連鎖攻擊」支援。
MID_TUT_STYLE_COOP_1	攻擊敵人時，若【連攜】類型的\n我方單位可以攻擊相同敵人，\n該單位就會加入戰鬥一起攻擊。
MID_TUT_STYLE_HORSE_TITLE	戰鬥類型【騎馬】
MID_TUT_STYLE_HORSE_0	戰鬥類型為【騎馬】的單位\n比起其他類型擁有更高的移動力。
MID_TUT_STYLE_HORSE_1	該類型善於活用本身的高機動性戰鬥，\n能夠殺入敵陣先發制人，\n或是自遠方長驅直入，解救身陷危機的夥伴。
MID_TUT_STYLE_COVERT_TITLE	戰鬥類型【隱密】
MID_TUT_STYLE_COVERT_0	戰鬥類型為【隱密】的單位\n會讓地形效果的+補正變成兩倍。
MID_TUT_STYLE_COVERT_1	該類型在「草叢」等地形較多的地方，\n更可妥善利用地形，讓戰局更加有利。
MID_TUT_STYLE_HEAVY_TITLE	戰鬥類型【重裝】
MID_TUT_STYLE_HEAVY_0	戰鬥類型為【重裝】的單位\n即使遭到「互克上占優勢的武器」攻擊，\n也不會陷入打破狀態。
MID_TUT_STYLE_HEAVY_1	此外，該類型的HP及防守較高，\n因此非常適合擺在前線抵禦攻擊。\n但「魔防」較低，必須提防魔法攻擊。
MID_TUT_STYLE_FLY_TITLE	戰鬥類型【飛行】
MID_TUT_STYLE_FLY_0	戰鬥類型為【飛行】的單位\n移動時不會受到地形或地形效果影響，\n還能進入「無法步行」的地形。
MID_TUT_STYLE_FLY_1	該類型雖然擁有極高的移動能力，\n但不擅抵禦弓箭等擁有「克制飛行」的武器，\n必須多加注意。
MID_TUT_STYLE_DRAGON_TITLE	戰鬥類型【龍族】
MID_TUT_STYLE_DRAGON_0	戰鬥類型為【龍族】的單位\n必定能賦予結合特技\n或結合技追加效果。
MID_TUT_STYLE_DRAGON_1	該類型可善用紋章士的能力作戰，\n因此若預先提升與各紋章士間的牽絆，\n更能進一步拓展戰術。
MID_TUT_STYLE_BATTLE_TITLE	戰鬥類型
MID_TUT_STYLE_BATTLE_0	單位有【騎馬】【氣功】【魔道】等\n各種「戰鬥類型」，每種類型皆有不同的特長。
MID_TUT_STYLE_BATTLE_1	可在狀態中查看\n各單位分別為哪種「戰鬥類型」。
MID_TUT_BMAP_ITEMDROP_TITLE	掉落道具
MID_TUT_BMAP_ITEMDROP_0	打倒身上有「掉落圖示」的敵人，\n就可獲得該名敵人身上的道具。
MID_TUT_BMAP_ITEMDROP_1	可獲得的道具將會以「綠色」字樣\n顯示在該名敵人的狀態欄位。
MID_TUT_BMAP_XHELP_TITLE	詳細資訊
MID_TUT_BMAP_XHELP_0	將游標對準單位並按下\x0E\x08\x02\x04\x02X鍵，\n即可查看該單位的「詳細資訊」。
MID_TUT_BMAP_XHELP_1	移動游標即可查看「武器」與「特技」等\n各種欲確認的「詳細資訊」。
MID_TUT_BMAP_XHELP_2	再次按下\x0E\x08\x02\x04\x02X鍵\n或按下\x0E\x08\x02\x04\x02B鍵即可回到原本畫面。
MID_TUT_BMAP_BONDSSUPPORTTALK_TITLE	牽絆對話
MID_TUT_BMAP_BONDSSUPPORTTALK_0	我方單位和紋章士的牽絆等級提升後，\n就能看到「牽絆對話」。
MID_TUT_BMAP_BONDSSUPPORTTALK_1	玩家可在世界地圖或據點索拉涅爾時\n觀看「牽絆對話」。
MID_TUT_BMAP_BONDSSUPPORTTALK_2	觀看「牽絆對話」可進一步提高牽絆等級。
MID_TUT_BMAP_SUPPORT_TITLE	支援效果
MID_TUT_BMAP_SUPPORT_0	與我方單位相鄰戰鬥或\n回復HP會提高支援值，\n就能看到「支援對話」。
MID_TUT_BMAP_SUPPORT_1	玩家可在世界地圖\n或據點索拉涅爾觀看「支援對話」，\n完成對話後可提升彼此的「支援等級」。
MID_TUT_BMAP_SUPPORT_2	我方單位的「支援等級」越高，\n能受到的「支援效果」越高，\n與該單位相鄰時就能提升能力。
MID_TUT_BMAP_VISIT_TITLE	訪問
MID_TUT_BMAP_VISIT_0	只要「訪問」民宅通知居民有危險，\n就能獲得道具或金幣等獎勵。
MID_TUT_BMAP_VISIT_1	讓我方單位移動到民宅前發光的格子，\n即可選擇「訪問」。
MID_TUT_BMAP_VISIT_2	敵人到達民宅後會破壞民宅，\n還請多加留意。
MID_TUT_BMAP_TIMECRYSTAL_TITLE	龍之時水晶
MID_TUT_BMAP_TIMECRYSTAL_0	使用「龍之時水晶」，\n便能回到之前的時間點，重新安排行動。
MID_TUT_BMAP_TIMECRYSTAL_1	可使用選單中的「龍之時水晶」。\n用\x0E\x08\x02\x06\x04Up\x0E\x08\x02\x0A\x08Down選擇要返回的時間點，\n再按下\x0E\x08\x02\x04\x02A鍵決定。
MID_TUT_BMAP_REINFORCEMENT_TITLE	增援
MID_TUT_BMAP_REINFORCEMENT_0	出擊期間有時會出現\n敵人的「增援」。
MID_TUT_BMAP_REINFORCEMENT_1	「增援」有時會從「堡壘」或「地圖的邊界」出現，\n慎重起見，最好還是小心行動。
MID_TUT_BMAP_TRANSPORTER_TITLE	運輸隊
MID_TUT_BMAP_TRANSPORTER_0	透過「運輸隊」就能保管\n身上帶不了的武器跟道具，\n或在需要時取出。
MID_TUT_BMAP_TRANSPORTER_1	\x0E\x06\x03\x00\n或與\x0E\x06\x03\x00相鄰的我方單位\n可在出擊期間使用該功能。
MID_TUT_BMAP_DEADSOUL_TITLE	戰死者之魂
MID_TUT_BMAP_DEADSOUL_0	連接網路後，根據全世界\n玩過該地圖玩家的戰鬥記錄，\n地圖上有機率出現「戰死者之魂」。
MID_TUT_BMAP_DEADSOUL_1	地圖中，較常有我方單位被擊敗\n的格子上會出現「黃色魂魄」，\n在該格子待命將可獲得經驗值和牽絆經驗值。
MID_TUT_BMAP_DEADSOUL_2	地圖中，較常有敵方單位被擊敗\n的格子上會出現「紫色魂魄」，\n在該格子待命將可獲得道具。
MID_TUT_BMAP_DOOR_TITLE	門扉
MID_TUT_BMAP_DOOR_0	攻擊並破壞「門扉」，\n便可通過該處。
MID_TUT_BMAP_DOOR_1	若我方有「小偷」，\n就可使用指令「門扉鑰匙」，\n不須破壞即可打開門扉。
MID_TUT_BMAP_TREASUREBOX_TITLE	寶箱
MID_TUT_BMAP_TREASUREBOX_0	「寶箱」裡放有道具，\n只要移動到寶箱的相鄰位置並使用\n指令「寶箱」就能獲得裡頭的東西。
MID_TUT_BMAP_TREASUREBOX_1	即使敵人拿走寶箱裡的道具，\n但只要在該名敵人逃走前將其擊敗，\n即能拿回物品。
MID_TUT_BMAP_BREAKINGWALL_TITLE	破壞地形
MID_TUT_BMAP_BREAKINGWALL_0	可攻擊並破壞地形資訊中\n顯示「可破壞」的地形。
MID_TUT_BMAP_BREAKINGWALL_1	破壞地形後，便可通過該處。
MID_TUT_BMAP_HPSTOCK_TITLE	復活之石
MID_TUT_BMAP_HPSTOCK_0	部分強敵會攜帶「復活之石」。
MID_TUT_BMAP_HPSTOCK_1	即使HP歸零，\n敵人也會使用此物品復活及回復。
MID_TUT_BMAP_HPSTOCK_2	敵人身上若有「復活之石」就無法將其打倒，\n不停發動攻擊，讓敵人把復活之石用完吧。
MID_TUT_BMAP_INTERFERINGCANE_TITLE	妨礙杖
MID_TUT_BMAP_INTERFERINGCANE_0	有些法杖可設置障礙物\n或妨礙敵人的行動。
MID_TUT_BMAP_SEARCH_TITLE	黑暗
MID_TUT_BMAP_SEARCH_0	在「黑暗」的地圖上，\n只能看到我方單位的周圍，\n以及「篝火」跟「火把」的照明範圍。
MID_TUT_BMAP_SEARCH_1	即使有伏兵，\n也無從得知敵人的行蹤，\n行軍時請小心前進。
MID_TUT_BMAP_POISON_TITLE	異常狀態「中毒」
MID_TUT_BMAP_POISON_0	小偷使用擅長的「短劍」\n對敵人造成傷害後，\n可使對方陷入「中毒」狀態。
MID_TUT_BMAP_POISON_1	攻擊陷入「中毒」狀態的敵人，\n可造成比平常更多的傷害。
MID_TUT_BMAP_POISON_2	此外，若短劍再次命中\n「中毒」狀態的敵人，\n將可增強毒性。
MID_TUT_BMAP_POISON_3	若不使用「解毒劑」或「休息」之杖解毒，\n「中毒」狀態會持續至整場戰鬥結束。
MID_TUT_BMAP_TORCH_TITLE	篝火
MID_TUT_BMAP_TORCH_0	移動到未點燃的「篝火」旁邊，\n就能使用指令「篝火」點燃。
MID_TUT_BMAP_TORCH_1	只要點燃篝火就能照亮周圍，\n將更容易發現潛伏的敵人。
MID_TUT_BMAP_SMASH_TITLE	猛擊
MID_TUT_BMAP_SMASH_0	「鐵大劍」和「鐵大槍」等大型武器\n在由自身主動攻擊時必定為後攻，\n但會發動「猛擊」，讓敵人往後退1格。
MID_TUT_BMAP_SMASH_1	若敵人後退的位置上\n有其他單位或牆壁等障礙物，\n敵人將會陷入打破狀態。
MID_TUT_BMAP_SMASH_2	此類武器的威力強大且相當實用，\n但攻速較慢，無法施展追擊，需多加留意。
MID_TUT_BMAP_DARKSYNCHRO_TITLE	闇之同步
MID_TUT_BMAP_DARKSYNCHRO_0	敵人中也有和紋章士\n「闇之同步」的單位。
MID_TUT_BMAP_DARKSYNCHRO_1	以暗黑力量同步的單位\n不須與紋章士結合就可施放結合技。
MID_TUT_BMAP_DARKSYNCHRO_2	當敵人可以施放結合技時，\n此處就會發光，務必多加留意。
MID_TUT_BMAP_BOWTURRET_TITLE	弓弩炮台
MID_TUT_BMAP_BOWTURRET_0	若單位持有可攻擊的弓，\n只要移動到「弓弩炮台」\n就能使用指令「炮擊」。
MID_TUT_BMAP_BOWTURRET_1	「炮擊」不僅威力強大，射程也非常遠，\n可對遠處的敵人造成大量傷害。
MID_TUT_BMAP_BOWTURRET_2	但攻擊的次數有限，\n必須妥善利用。
MID_TUT_BMAP_CONVERSATION_TITLE	對話
MID_TUT_BMAP_CONVERSATION_0	和顯示「對話圖示」的單位相鄰時，\n只要使用指令「對話」，就可與其交談。
MID_TUT_BMAP_CONVERSATION_1	交談後有機會使對方加入我方，\n看到該圖示時請盡量與其「對話」。
MID_TUT_BMAP_CONVERSATION_2	有時只有特定的我方單位能與其交談。
MID_TUT_BMAP_MAGICTURRET_TITLE	魔炮台
MID_TUT_BMAP_MAGICTURRET_0	若單位持有可使用的魔道書，\n只要移動到「魔炮台」\n就能使用指令「炮擊」。
MID_TUT_BMAP_MAGICTURRET_1	「炮擊」不僅威力強大，射程也非常遠，\n可對遠處的敵人造成大量傷害。
MID_TUT_BMAP_MAGICTURRET_2	魔炮台和弓弩炮台一樣攻擊的次數有限，\n必須妥善利用。
MID_TUT_BMAP_QUICKSAND_TITLE	流沙
MID_TUT_BMAP_QUICKSAND_0	「流沙」是一種特殊地形，\n在離開該地形時\n需消耗較多的移動力。
MID_TUT_BMAP_QUICKSAND_1	若不小心進入該地形，\n行動將會受限，\n小心別讓自己處於劣勢了。
MID_TUT_BMAP_RECKLESS_TITLE	失控
MID_TUT_BMAP_RECKLESS_0	「闇之同步」中的敵人\n使用「復活之石」復活時\n有機會進入「失控」狀態。
MID_TUT_BMAP_RECKLESS_1	此時會讓紋章士的力量失控，\n敵人也會因此變得更加強大，\n務必多加小心。
MID_TUT_BMAP_DANCE_TITLE	起舞
MID_TUT_BMAP_DANCE_0	舞蹈家與結束行動的\n我方單位相鄰時，\n可使用指令「起舞」。
MID_TUT_BMAP_DANCE_1	使用指令「起舞」後，\n我方單位的狀態將變回未行動，\n可再次展開行動。
MID_TUT_BMAP_FLAMETURRET_TITLE	火炎炮台
MID_TUT_BMAP_FLAMETURRET_0	單位移動到「火炎炮台」後，\n就能使用指令「炮擊」。
MID_TUT_BMAP_FLAMETURRET_1	火炎炮台的「炮擊」攻擊範圍相當廣，\n會在落點一帶製造「火焰」效果。
MID_TUT_BMAP_FLAMETURRET_2	此攻擊非常實用，\n但要注意可能會波及到我方單位，\n此外也無法使敵人的HP歸零。
MID_TUT_BMAP_PICKUPARING_TITLE	蒐集戒指
MID_TUT_BMAP_PICKUPARING_0	只要讓\x0E\x06\x03\x00\n在掉落的戒指附近待命，\n就能顯現紋章士。
MID_TUT_BMAP_LINKINGUP_TITLE	出擊期間同步
MID_TUT_BMAP_LINKINGUP_0	未持有戒指\x0E\x01\x08\x00的我方單位\n只要移動到顯現的紋章士旁邊\n並與其「對話」就能同步。
MID_TUT_BMAP_DRAGONCREST_TITLE	邪龍紋
MID_TUT_BMAP_DRAGONCREST_0	想要破壞「邪龍紋」，\n就得擊敗守紋的敵方將領\n「賽皮雅」與「孤慄」。
MID_TUT_BMAP_DRAGONCREST_1	他們會使用邪龍紋之力\n在戰場上降下「火山彈」。
MID_TUT_BMAP_VOLCANICBOMB_TITLE	火山彈
MID_TUT_BMAP_VOLCANICBOMB_0	「火山彈」每經過幾回合\n就會出現一次。
MID_TUT_BMAP_VOLCANICBOMB_1	我方單位被火山彈擊中時會受到大量的傷害。\n此外，火山彈還會破壞落點的障礙物（巨岩）。
MID_TUT_BMAP_VOLCANICBOMB_2	落點會提前標示在地圖上，\n請避開這些地方以免受到波及。
MID_TUT_BMAP_AVALANCHE_TITLE	雪崩
MID_TUT_BMAP_AVALANCHE_0	邪龍\x0E\x06\x03\x00\n會使用邪龍紋之力引發「雪崩」，\n捲走我方單位。
MID_TUT_BMAP_AVALANCHE_1	「雪崩」的地點會提前標示在地圖上，\n盡可能避開這些地方以免受到波及。
MID_TUT_BMAP_AVALANCHE_2	被捲走時若碰到岩石或敵人，\n將會停在該處。
MID_TUT_BMAP_TURNLIMIT_TITLE	回合限制
MID_TUT_BMAP_TURNLIMIT_0	部分戰鬥會規定要在幾回合內過關。
MID_TUT_BMAP_TURNLIMIT_1	一旦超過指定回合將會敗北，\n在此之前達成勝利條件吧。
MID_TUT_BMAP_DRAGONBEAM_TITLE	邪龍紋炮
MID_TUT_BMAP_DRAGONBEAM_0	異形琉彌艾爾會使用邪龍紋之力\n發動廣域攻擊「邪龍紋炮」。
MID_TUT_BMAP_DRAGONBEAM_1	「邪龍紋炮」的命中範圍會提前標示在地圖上，\n請避開這些地方以免受到波及。
MID_TUT_BMAP_DARKHERALDIC_TITLE	暗黑紋章士
MID_TUT_BMAP_DARKHERALDIC_0	「暗黑紋章士」雖為強敵，若有紋章士與他們\n出身相同異界，只要我方單位與其同步、結合，\n發動的攻擊即可對暗黑紋章士造成大量傷害。
MID_TUT_BMAP_BARRIER_TITLE	闇之結界
MID_TUT_BMAP_BARRIER_0	暗黑紋章士們設下的「闇之結界」\n正保護著大邪龍尚卜爾，\n減少他受到的傷害。
MID_TUT_BMAP_BARRIER_1	只要打敗「暗黑紋章士」\n就能削弱「闇之結界」的效果。
MID_TUT_BMAP_ENGAGERING_TITLE	約定戒指
MID_TUT_BMAP_ENGAGERING_0	「約定戒指」是能與對方建立緊密牽絆的道具，\n可以將戒指交給支援等級為A的夥伴。
MID_TUT_BMAP_ENGAGERING_1	戒指保管在「我的房間」裡的「我的櫃子」，\n需要時就取出戒指，交給自己選中的對象吧。
MID_TUT_BMAP_ENGAGERING_2	若對方沒有在索拉涅爾，\n只要在我的床上休息，\n或許就能見到對方。
MID_TUT_GOD_MARTH_TITLE	紋章士馬爾斯
MID_TUT_GOD_MARTH_0	「紋章士馬爾斯」擅長使出華麗的連續攻擊，\n與利用矯健的身手將敵人玩弄於股掌之間。
MID_TUT_GOD_MARTH_1	同步技「識破」可讓人在攻擊時\n更容易回避敵人的反擊。
MID_TUT_GOD_MARTH_2	結合武器「刺劍」\n可對騎馬的敵人及重裝兵造成大量傷害。
MID_TUT_GOD_MARTH_3	結合特技「神速」\n可使攻擊次數+1。
MID_TUT_GOD_MARTH_4	結合技「星之突擊」\n可使出快到看不見的連續攻擊，\n對敵人造成大量傷害。
MID_TUT_GOD_SIGLUD_TITLE	紋章士西格爾特
MID_TUT_GOD_SIGLUD_0	「紋章士西格爾特」擁有高機動力，\n可在戰場上縱橫自如。
MID_TUT_GOD_SIGLUD_1	同步技「再移動」\n可讓人在攻擊後再移動1次。
MID_TUT_GOD_SIGLUD_2	結合武器「騎士殺手」\n可對騎馬的敵人造成大量傷害。
MID_TUT_GOD_SIGLUD_3	結合特技「快跑」\n可使移動+5。
MID_TUT_GOD_SIGLUD_4	結合技「破陣星馳」\n可攻擊位於同一直線上的敵人，\n並移動至其身後。
MID_TUT_GOD_CELICA_TITLE	紋章士賽莉卡
MID_TUT_GOD_CELICA_0	「紋章士賽莉卡」擅長使用魔法攻擊，\n可對「異形兵」等異形類敵人發揮強大效果。
MID_TUT_GOD_CELICA_1	同步技「異形復仇」\n可在受到異形類敵人攻擊時，\n將部分所受傷害反擊給對方。
MID_TUT_GOD_CELICA_2	結合武器「天使」\n可對異形類敵人造成大量傷害。
MID_TUT_GOD_CELICA_3	結合特技「重唱」\n能以50%傷害的魔法發動2次攻擊。
MID_TUT_GOD_CELICA_4	結合技「傳送末世烈焰」\n可傳送至遠處的敵人附近，\n並對其發動強勁的魔法攻擊。
MID_TUT_GOD_MICAIAH_TITLE	紋章士米卡雅
MID_TUT_GOD_MICAIAH_0	「紋章士米卡雅」擁有強大的魔力\n與治療之術，擅長回復我方單位。
MID_TUT_GOD_MICAIAH_1	同步技「操杖」可讓同步時的我方單位\n不受兵種影響，亦能使用杖。
MID_TUT_GOD_MICAIAH_2	結合武器「閃光」\n可發動光魔法攻擊，\n攻擊結束後還能照亮四周。
MID_TUT_GOD_MICAIAH_3	結合特技「增幅」\n可增加杖的射程和效果範圍。
MID_TUT_GOD_MICAIAH_4	結合技「大治癒之手」\n可完全回復我方全員的HP，\n但使用後會減少自身的HP。
MID_TUT_GOD_ROY_TITLE	紋章士羅伊
MID_TUT_GOD_ROY_0	「紋章士羅伊」攻守兼備，\n擅長於戰場前線大顯身手。
MID_TUT_GOD_ROY_1	同步技「堅持」可讓人受到足以致命的傷害時，\n仍能以HP剩下1的狀態存活下來。
MID_TUT_GOD_ROY_2	結合武器「破槍劍」\n可倒轉武器的互克，使持槍的敵人陷入打破狀態。\n（持斧的敵人會使自身陷入打破狀態）
MID_TUT_GOD_ROY_3	結合特技「超越」\n可暫時提高等級，\n大幅增強能力。
MID_TUT_GOD_ROY_4	結合技「獅子紅蓮焰舞」\n可對前方的敵人們造成傷害，\n並產生阻擋去路的「火焰」。
MID_TUT_GOD_LEAF_TITLE	紋章士里弗
MID_TUT_GOD_LEAF_0	「紋章士里弗」擅長使用各種武器，\n可依據戰況隨時調整戰鬥方式。
MID_TUT_GOD_LEAF_1	同步技「避開要害」\n可在武器互克上占優勢時，\n讓所受傷害減少。
MID_TUT_GOD_LEAF_2	結合武器「必殺斧」\n較容易使出必殺攻擊。
MID_TUT_GOD_LEAF_3	結合特技「瞬應」可在受到敵人攻擊時，\n自動更換為較占優勢的武器並反擊。
MID_TUT_GOD_LEAF_4	結合技「四重巧擊」\n可使用劍、槍、斧、弓施展連續攻擊，\n還有高機率使敵人陷入打破狀態。
MID_TUT_GOD_LIN_TITLE	紋章士琳
MID_TUT_GOD_LIN_0	「紋章士琳」擅長使出猛烈攻擊，\n讓對手毫無機會反擊，藉此取勝。
MID_TUT_GOD_LIN_1	同步技「強攻」\n可在自身的速度遠高於敵人時，\n搶先在敵人反擊前施展追擊。
MID_TUT_GOD_LIN_2	結合武器「必殺弓」\n較容易使出必殺攻擊。
MID_TUT_GOD_LIN_3	結合特技「殘像」會在自身周圍創造出殘像，\n殘像能參與「連鎖攻擊」，也能當作「誘餌」。
MID_TUT_GOD_LIN_4	結合技「流星群」\n可用弓箭從超遠距離\n單方面連續攻擊敵人5次。
MID_TUT_GOD_LUCINA_TITLE	紋章士露琪娜
MID_TUT_GOD_LUCINA_0	紋章士露琪娜擅長與夥伴並肩作戰，\n待在我方單位附近時可發揮強大的力量。
MID_TUT_GOD_LUCINA_1	同步技「雙重攻擊」可讓同步時的\n我方單位不受戰鬥類型影響，\n亦能施展「連鎖攻擊」。
MID_TUT_GOD_LUCINA_2	結合武器「王室貴族刺劍」\n可對騎馬的敵人及重裝兵造成大量傷害。
MID_TUT_GOD_LUCINA_3	結合特技「牽絆之盾」\n有高機率使所有相鄰的\n我方單位所受攻擊無效。
MID_TUT_GOD_LUCINA_4	結合技「人人為我」可讓周圍2格內的我方單位\n不受戰鬥類型影響，亦能參與「連鎖攻擊」。
MID_TUT_GOD_IKE_TITLE	紋章士艾克
MID_TUT_GOD_IKE_0	「紋章士艾克」擁有優異的攻擊力和耐久力，\n受到的傷害越大越能發揮他強大的力量。
MID_TUT_GOD_IKE_1	同步技「勇將」\n會在HP減少時提升防守和魔防。
MID_TUT_GOD_IKE_2	結合武器「戰錘」可對敵人猛擊，\n並能對重裝兵造成大量傷害。
MID_TUT_GOD_IKE_3	結合特技「不動」\n會使所受傷害減半，\n但回避會變為0。
MID_TUT_GOD_IKE_4	結合技「霸克・天空」\n會在1回合內加強防守，抵禦敵人的攻擊，\n下回合還會發動範圍攻擊並回復HP。
MID_TUT_GOD_KAMUI_TITLE	紋章士神威
MID_TUT_GOD_KAMUI_0	「紋章士神威」可控制敵人的行動和地形效果，\n將戰局導向對我軍有利的方向。
MID_TUT_GOD_KAMUI_1	同步技「龍脈」可依據我方單位\n同步時的戰鬥類型賦予地形各種特殊效果，\n並消除該地形上的「火焰」跟「瘴氣」等效果。
MID_TUT_GOD_KAMUI_2	結合武器「逆刀」\n可倒轉武器的互克，使持槍的敵人陷入打破狀態。\n（若被持斧的敵人攻擊，則自身會陷入打破狀態）
MID_TUT_GOD_KAMUI_3	結合特技「咒縛」\n會在自身發動攻擊後，\n使對方與其周圍1格的敵人無法移動1回合。
MID_TUT_GOD_KAMUI_4	結合技「龍穿炮」會一次攻擊前方敵人，\n並賦予地形「水窪」的效果。\n（與龍脈相同，可消除「火焰」等效果）
MID_TUT_GOD_BYLETH_TITLE	紋章士貝雷特
MID_TUT_GOD_BYLETH_0	「紋章士貝雷特」可提升多名我方單位的能力，\n引導我軍取得勝利。
MID_TUT_GOD_BYLETH_1	同步技「天刻之脈動」\n有一定機率使本該失手的攻擊命中敵人。
MID_TUT_GOD_BYLETH_2	結合武器「英雄的遺產」\n可依據我方單位結合時的戰鬥類型\n使用不同的特殊武器。
MID_TUT_GOD_BYLETH_3	結合特技「指導」\n會提升周圍我方單位的基本能力值。
MID_TUT_GOD_BYLETH_4	結合技「計策：女神之舞」\n可讓相鄰的我方全員再次行動，\n並提升基本能力值。
MID_TUT_GOD_EIRIK_TITLE	紋章士艾莉可
MID_TUT_GOD_EIRIK_0	「紋章士艾莉可」和雙胞胎哥哥艾夫拉姆可交替上場，\n並依據戰況不同切換為適合的能力。
MID_TUT_GOD_EIRIK_1	同步技「月之手鐲」在攻擊時，\n面對的敵人防守越高，\n造成的傷害越大。
MID_TUT_GOD_EIRIK_2	結合武器「刺劍」\n可對騎馬的敵人及重裝兵造成大量傷害。
MID_TUT_GOD_EIRIK_3	結合特技「雙聖」\n可同時發動艾莉可和艾夫拉姆的特技。
MID_TUT_GOD_EIRIK_4	結合技「雙流」在以劍與槍\n攻擊時容易對敵人造成打破效果，\n更可對異形類敵人造成大量傷害。
MID_TUT_GOD_LUEUR_TITLE	紋章士\x0E\x06\x03\x00
MID_TUT_GOD_LUEUR_0	「紋章士\x0E\x06\x03\x00」無須同步，\n只要在出擊期間使用「結合+」，\n即可與任何人結合。
MID_TUT_GOD_LUEUR_1	同步技「繫承牽絆者」\n可提升自身與附近正在同步、結合的\n我方單位的命中及回避。
MID_TUT_GOD_LUEUR_2	結合武器「萊拉西昂」\n會在自身發動攻擊並擊敗敵人時，\n增加所有同步中的相鄰我方單位結合計量條。
MID_TUT_GOD_LUEUR_3	結合特技「以心」\n會在自身發動攻擊並擊敗敵人時，\n大幅提升結合對象的基本能力。
MID_TUT_GOD_LUEUR_4	結合技「神龍破」\n為施展劍與光束（魔法）的連續攻擊，\n對高防守、高魔防的敵人，亦能造成大量傷害。
MID_TUT_GOD_LUEUR_KL_TITLE	紋章士\x0E\x06\x03\x00的牽絆等級
MID_TUT_GOD_LUEUR_KL_0	紋章士\x0E\x06\x03\x00提升「牽絆等級」的方法\n和其他紋章士不同，不是透過牽絆經驗值，\n而是要提升和夥伴間的支援等級。
MID_TUT_GOD_LUEUR_KL_1	若和夥伴的支援等級未達C則為「牽絆等級1」，\n是C則為「牽絆等級5」，是B則為「牽絆等級10」，\n是A則為「牽絆等級20」。
MID_TUT_ENGAGE_PLUS_TITLE	結合+
MID_TUT_ENGAGE_PLUS_0	\x0E\x06\x03\x00在結合計量條儲滿的狀態下，\n與欲結合的我方單位相鄰，\n即可選擇「結合+」。
MID_TUT_ENGAGE_PLUS_1	選擇的對象與紋章士\x0E\x06\x03\x00\n進入結合狀態的同時，\n\x0E\x06\x03\x00自身亦會進入結合狀態。
MID_TUT_ENGAGE_PLUS_2	若與結合對象相鄰，\n結合技將會變成「牽絆・神龍破」，\n可藉此施展出強大的攻擊。
MID_TUT_BMAP_SORTIE_TITLE	出擊準備
MID_TUT_BMAP_SORTIE_0	在開始戰鬥前，可在「出擊準備」中\n選擇出擊的我方單位、\n紋章士戒指\x0E\x01\x08\x00及持有物品。
MID_TUT_BMAP_SORTIE_1	準備好後只要選擇「戰鬥開始」，\n即可出擊前往戰場。
MID_TUT_BMAP_UNIT_SELECT_TITLE	編組單位
MID_TUT_BMAP_UNIT_SELECT_0	可在「編組單位」中，\n以\x0E\x08\x02\x04\x02A鍵開啟/關閉\x0E\x08\x02\x16\x14IconSortie\n來選擇要在該地圖出擊的成員。
MID_TUT_BMAP_UNIT_SELECT_1	「綠色框框」的我方單位\n須在該地圖強制出擊，\n無法更改。
MID_TUT_BMAP_UNIT_SELECT_2	每個戰鬥地圖可出擊的\n我方單位總數均為固定。
MID_TUT_BMAP_MAPVERIFICATION_TITLE	更改配置
MID_TUT_BMAP_MAPVERIFICATION_0	可在「更改配置」替換更改\n我方單位出擊時的位置。
MID_TUT_BMAP_MAPVERIFICATION_1	首先，以\x0E\x08\x02\x04\x02A鍵選擇欲更改位置的我方單位。
MID_TUT_BMAP_MAPVERIFICATION_2	接著，以\x0E\x08\x02\x04\x02A鍵選擇其他我方單位，\n即可調換兩人的位置。\n（有些我方單位無法更換位置）
MID_TUT_BMAP_MAPVERIFICATION_3	此時只要移動游標，\n即可查看地形資訊及敵人的能力。
MID_TUT_BMAP_HERALDICCHOICE_TITLE	紋章士戒指\x0E\x01\x08\x00
MID_TUT_BMAP_HERALDICCHOICE_0	可在「紋章士戒指\x0E\x01\x08\x00」中，\n決定或更改與我方單位同步的紋章士。
MID_TUT_BMAP_HERALDICCHOICE_1	只要透過選擇「我方單位」→「戒指\x0E\x01\x08\x00」，\n即可決定該如何配搭。
MID_TUT_BMAP_GETTINGDRESSED_TITLE	整備
MID_TUT_BMAP_GETTINGDRESSED_0	在「整備」中可整理\n出擊期間欲使用的武器及道具。
MID_TUT_BMAP_GETTINGDRESSED_1	在「整理持有物品」、「交換持有物品」中\n可整理我方單位持有的武器及道具，\n或是與運輸隊及其他我方單位交換武器及道具。
MID_TUT_BMAP_GETTINGDRESSED_2	如果選擇「自動裝備」，\n就會從持有的道具中自動選擇適合的物品。
MID_TUT_BMAP_GETTINGDRESSED_3	若選擇「保管所有物品」，\n則可把持有道具都交給運輸隊保管。
MID_TUT_BMAP_EQUIP_SKILL_TITLE	特技裝備
MID_TUT_BMAP_EQUIP_SKILL_0	可在「整備」中的「特技裝備」\n查看已習得的「特技」\n及更換「繼承特技」。
MID_TUT_BMAP_EQUIP_SKILL_1	「繼承特技」可在索拉涅爾的\n「紋章士之間」等地從紋章士身上繼承。
MID_TUT_BMAP_CLASSCHANGE_TITLE	轉職
MID_TUT_BMAP_CLASSCHANGE_0	持有「大師證」就能讓等級10以上的\n我方單位「轉職」為高級兵種。
MID_TUT_BMAP_CLASSCHANGE_1	成為高級兵種後單位會進一步強化，\n不僅能力值提升，可使用的武器也會增加。
MID_TUT_BMAP_CLASSCHANGE_2	只要擁有「轉職證」\n就可「轉職」成其他類型的兵種。
MID_TUT_BMAP_CLASSCHANGE_3	可以從「整備」中「轉職」。
MID_TUT_BMAP_APTITUDE_TITLE	資質
MID_TUT_BMAP_APTITUDE_0	需要擁有特定的「資質」\n才可轉職為其他兵種。
MID_TUT_BMAP_APTITUDE_1	一開始擁有的資質為「天賦資質」，\n若轉職成能善用此資質的兵種，\n則可發揮其優秀的才能。
MID_TUT_BMAP_APTITUDE_2	可從紋章士身上繼承\n尚未擁有的「資質」，\n藉此轉職成喜歡的兵種。
MID_TUT_GMAP_BASIC_TITLE	世界地圖
MID_TUT_GMAP_BASIC_0	要在「世界地圖」執行操作\n才可前往下一章或目的地。
MID_TUT_GMAP_BASIC_1	移動\x0E\x06\x03\x00至欲前往的地方，\n再按下\x0E\x08\x02\x04\x02A鍵打開選單，\n即可推進劇情。
MID_TUT_GMAP_BASIC_2	玩家可從選單執行整備\n或返回據點索拉涅爾。
MID_TUT_GMAP_SIDE_TITLE	外傳
MID_TUT_GMAP_SIDE_0	若持續推進遊戲，\n有時世界地圖會出現「外傳地圖」。
MID_TUT_GMAP_SIDE_1	玩家可自由決定是否要前往外傳地圖，\n但外傳中可能會有新夥伴加入或有些好機遇，\n非常值得造訪看看。
MID_TUT_GMAP_ENCOUNT_TITLE	遭遇戰
MID_TUT_GMAP_ENCOUNT_0	至今為止在世界地圖上經過的地方\n可能會出現異形兵或該國的士兵。
MID_TUT_GMAP_ENCOUNT_1	只要移動到該處，\n即可展開「遭遇戰」或「訓練」。
MID_TUT_GMAP_ENCOUNT_2	可與一般的戰鬥同樣獲得經驗值，\n亦有機會得到金幣或道具，\n建議玩家可好好利用。
MID_TUT_GMAP_RANKING_TITLE	出擊排行榜
MID_TUT_GMAP_RANKING_0	只要連接網路，就能以排行榜的形式\n查看全世界的玩家在此地圖上派遣了\n哪些單位和紋章士出擊。
MID_TUT_GMAP_RANKING_1	建議可在編組單位，\n選擇出擊的我方單位時參考看看。
MID_TUT_KR_KIZUNARESULT_TITLE	散步
MID_TUT_KR_KIZUNARESULT_0	戰鬥結束就會開始「散步」，\n可在周圍走動，和夥伴對話。
MID_TUT_KR_KIZUNARESULT_1	有時還會發現掉落的道具，\n建議可到處找找。
MID_TUT_KR_KIZUNARESULT_2	想要結束散步時，可朝出口走去，\n或按下\x0E\x08\x02\x0A\x08Plus鍵打開選單並選擇「前往下個目的地」。
MID_TUT_KR_KIZUNAPIECE_TITLE	牽絆碎片
MID_TUT_KR_KIZUNAPIECE_0	「散步」時若與夥伴對話，\n就有機會獲得「牽絆碎片」。
MID_TUT_KR_KIZUNAPIECE_1	在索拉涅爾和紋章士鍛鍊\n或精煉牽絆戒指時需要用到「牽絆碎片」。
MID_TUT_KR_KIZUNAPIECE_2	結束「散步」時，\n若未獲得地圖上所有夥伴的「牽絆碎片」，\n也會在結束後自動取得剩下的「牽絆碎片」。
MID_TUT_HUB_BASIC_TITLE	據點
MID_TUT_HUB_BASIC_0	可在據點「索拉涅爾」準備下一場戰鬥\n或和夥伴們交流。
MID_TUT_HUB_BASIC_1	一開始能做的事不多，\n但隨著故事劇情的推進，\n將會慢慢增加可利用的設施。
MID_TUT_HUB_BASIC_2	當一切準備就緒，想前往下個章節時，\n請從入口或是選單中選擇「前往下個目的地」。
MID_TUT_HUB_CENTRALLOBBY_OPEN	可以利用「開放式茶座」了。
MID_TUT_HUB_CENTRALLOBBY_TITLE	開放式茶座
MID_TUT_HUB_CENTRALLOBBY_0	「開放式茶座」是夥伴們\n聚在一起休息的地方，\n有各式各樣的設備。
MID_TUT_HUB_CENTRALLOBBY_1	「音箱」可將索拉涅爾的\n背景音樂更改成自己喜歡的樂曲。\n
MID_TUT_HUB_CENTRALLOBBY_2	「布告欄」可以看到「據點情報」。\n另外，也可「投資」各國，\n或是查看目前為止的「成就」。
MID_TUT_HUB_INVESTMENT_TITLE	投資國家
MID_TUT_HUB_INVESTMENT_0	可在「投資國家」中向各國投資金幣。\n超過一定金額後會提升投資等級，\n並依等級收到不同謝禮。
MID_TUT_HUB_INVESTMENT_1	此外，在已提升等級的國家觸發遭遇戰時，\n有較高機率會出現稀有敵人，\n也較容易獲得金幣與經驗值。
MID_TUT_HUB_INVESTMENT_2	除此之外，亦會增加在該國散步時\n所能發現的材料，投資有非常多好處，\n若金錢充裕，不妨一試。
MID_TUT_HUB_INFORMATION_TITLE	據點情報
MID_TUT_HUB_INFORMATION_0	在「據點情報」中，\n可查看夥伴在索拉涅爾的位置，\n以及設施狀況等資訊。
MID_TUT_HUB_INFORMATION_1	選擇指定區域，\n即可瞬間移動至該區域。
MID_TUT_HUB_ACHIEVEMENT_TITLE	成就
MID_TUT_HUB_ACHIEVEMENT_0	在遊戲中達成各種行動後，\n即可在「成就」中領取獎勵「牽絆碎片」。
MID_TUT_HUB_ACHIEVEMENT_1	達成成就後會收到通知，\n記得要前往領取。
MID_TUT_HUB_MYROOM_TITLE	我的房間
MID_TUT_HUB_MYROOM_0	「我的房間」曾是\x0E\x06\x03\x00的沉睡之地，\n這裡放有「我的床」。
MID_TUT_HUB_MYROOM_1	選擇「休息」就可在床上休息一下，\n稍微推進索拉涅爾的時間。
MID_TUT_HUB_MYROOM_2	「休息」時可能會發生一些特別的事……？\n（建議使用耳機）
MID_TUT_HUB_MYROOM_3	選擇「回憶」就可再次觀看\n先前看過的支援對話或影片。
MID_TUT_HUB_MYROOM_4	選擇「更改難度」，\n即可更改遊戲的難度。\n（若難度為普通，則無法更改）
MID_TUT_HUB_WEAPONSHOP_OPEN	「武器店」和「道具店」開張了。
MID_TUT_HUB_WEAPONSHOP_TITLE	武器店
MID_TUT_HUB_WEAPONSHOP_0	可在「武器店」購買或販售\n戰鬥時使用的武器。
MID_TUT_HUB_WEAPONSHOP_1	一開始的商品種類很少，\n但隨著故事劇情的推進，\n店家會引進新商品，增加品項。
MID_TUT_HUB_ITEMSHOP_TITLE	道具店
MID_TUT_HUB_ITEMSHOP_0	可在「道具店」購買或販售\n「傷藥」或「杖」等戰鬥時使用的道具。
MID_TUT_HUB_ITEMSHOP_1	一開始的商品雖然不多，\n但隨著故事劇情的推進，\n將會慢慢增加品項。
MID_TUT_HUB_HERALDICSPACE_OPEN	可以進入「紋章士之間」了。
MID_TUT_HUB_HERALDICSPACE_TITLE	紋章士之間
MID_TUT_HUB_HERALDICSPACE_0	在「紋章士之間」可以做各種和紋章士有關的事情。\n透過「特技繼承」將可繼承紋章士擁有的特技。
MID_TUT_HUB_HERALDICSPACE_1	透過「精煉牽絆戒指」「合成牽絆戒指」\n將可用牽絆碎片來精煉「牽絆戒指」，\n或利用合成來強化戒指。
MID_TUT_HUB_HERALDICSPACE_2	透過「研磨戒指\x0E\x01\x08\x00」\n可以把戰鬥中弄髒的「紋章士戒指\x0E\x01\x08\x00」擦乾淨，\n加深和紋章士的牽絆。
MID_TUT_HUB_INHERITSKILL_TITLE	特技繼承
MID_TUT_HUB_INHERITSKILL_0	「特技繼承」可讓我方單位\n繼承紋章士的各種特技。
MID_TUT_HUB_INHERITSKILL_1	有「SP」且跟紋章士到達一定的「牽絆等級」\n才能夠執行「特技繼承」。「SP」可透過和\n紋章士同步或裝備「牽絆戒指」戰鬥時累積。
MID_TUT_HUB_INHERITSKILL_2	已繼承的特技需要裝備在單位身上才能發揮效果，\n可從「整備」中的「特技裝備」選擇想要裝備的特技。
MID_TUT_HUB_INHERITSKILL_3	若裝備的特技與同步中紋章士的\n「同步技」相同，效果將不會發動。\n避免裝備重複特技，才能發揮最大的效用。
MID_TUT_HUB_CREATE_RING_TITLE	精煉牽絆戒指
MID_TUT_HUB_CREATE_RING_0	牽絆碎片可用來精煉「牽絆戒指」。
MID_TUT_HUB_CREATE_RING_1	當成戒指裝備時可提升能力。\n雖不及「紋章士戒指\x0E\x01\x08\x00」，\n但可透過戰鬥累積SP。
MID_TUT_HUB_ENGWEAPON_REFINE_OPEN	能在「紋章士之間」「強化結合武器」了。
MID_TUT_HUB_ENGWEAPON_REFINE_TITLE	強化結合武器
MID_TUT_HUB_ENGWEAPON_REFINE_0	紋章士的「結合武器」可以利用下列方式強化。\n・使用紋晶石提升武器的各種能力\n・使用克制之書賦予武器各種克制效果
MID_TUT_HUB_ENGWEAPON_REFINE_1	強化所需的材料可透過挑戰\n「試煉別屋」中的「連戰的試煉」或「續戰的試煉」獲得。
MID_TUT_HUB_ENGWEAPON_REFINE_2	每樣結合武器都有「強化值上限」，\n超過上限就無法強化。
MID_TUT_HUB_ENGWEAPON_REFINE_3	強化的武器可以不限次數重置並重新強化。\n另外，只要提高紋章士和多位夥伴的牽絆等級，\n就會提升「強化值上限」，可進一步強化武器。
MID_TUT_HUB_MASCOT_OPEN	鐘乳洞瀰漫著一股神秘的氣息。
MID_TUT_HUB_MASCOT_TITLE	\x0E\x06\x05\x00
MID_TUT_HUB_MASCOT_0	「\x0E\x06\x05\x00」是個不可思議的生物，\n從很久以前就守護著這片土地。
MID_TUT_HUB_MASCOT_1	細心照顧這個小傢伙的話，\n說不定會發生什麼好事喔。
MID_TUT_HUB_MUSCLEEXERCISES_OPEN	可以玩「肌肉體操」了！
MID_TUT_HUB_MUSCLEEXERCISES_TITLE	肌肉體操
MID_TUT_HUB_MUSCLEEXERCISES_0	「肌肉體操」是一種活動，\n只要挑戰3種運動，就可暫時\n提高\x0E\x06\x03\x00的基本能力。
MID_TUT_HUB_MUSCLEEXERCISES_1	每種體操的操作方法\n與提升能力並不相同，\n目標是獲得最高評價！
MID_TUT_HUB_MUSCLEEXERCISES_2	推進故事劇情\n或許可以開啟更高的難度。
MID_TUT_HUB_ME_PUSHUPS_TITLE	伏地挺身
MID_TUT_HUB_ME_PUSHUPS_0	「伏地挺身」的重點在於按下按鍵的時機！\n讓加速的橫條停在最佳位置吧。\n失敗3次遊戲就會結束。
MID_TUT_HUB_ME_PUSHUPS_1	橫條的速度會逐漸加快，\n集中精神，不要分心了。
MID_TUT_HUB_ME_PUSHUPS_2	目標是Perfect Body！
MID_TUT_HUB_ME_SITUP_TITLE	仰臥起坐
MID_TUT_HUB_ME_SITUP_0	「仰臥起坐」是連按按鍵的體力賽！\n快速連按按鍵，把橫條推到最上面吧。\n橫條掉到最下面的話遊戲就會結束。
MID_TUT_HUB_ME_SITUP_1	越快集滿計量條，就能獲得越高的評價，\n但計量條會越來越難集滿。
MID_TUT_HUB_ME_SITUP_2	目標是Perfect Body！
MID_TUT_HUB_ME_SQUAT_TITLE	深蹲
MID_TUT_HUB_ME_SQUAT_0	「深蹲」比的是節奏感！\n配合朝著畫面上的指示操作\x0E\x08\x02\x0E\x0CStickL\x0E\x08\x02\x0E\x0CStickR吧。\n失敗3次遊戲就會結束。
MID_TUT_HUB_ME_SQUAT_1	「推動\x0E\x08\x02\x0E\x0CStickL\x0E\x08\x02\x0E\x0CStickR」\n「將\x0E\x08\x02\x0E\x0CStickL\x0E\x08\x02\x0E\x0CStickR轉一圈」\n掌握上面兩種操作方式吧。
MID_TUT_HUB_ME_SQUAT_2	目標是Perfect Body！
MID_TUT_HUB_ARENA_OPEN	可以利用「鍛鍊之間」了。
MID_TUT_HUB_ARENA_TITLE	鍛鍊之間
MID_TUT_HUB_ARENA_0	在「鍛鍊之間」可選擇夥伴，\n透過參加模擬戰獲得「經驗值」或「牽絆經驗值」。
MID_TUT_HUB_ARENA_1	「一般鍛鍊」是和夥伴的模擬戰。\n不須消費道具，但參加次數有限，\n也會隨機決定對手。
MID_TUT_HUB_ARENA_2	「特別指名鍛鍊」是與紋章士的模擬戰。\n雖得消費「牽絆碎片」，但不限次數，\n且跟指名對象必定可提升牽絆等級。
MID_TUT_HUB_ANIMAL_OPEN	可以「收容動物」了。
MID_TUT_HUB_ANIMAL_TITLE	動物
MID_TUT_HUB_ANIMAL_0	可收容在散步時遇到的「動物」，\n將其帶回索拉涅爾。
MID_TUT_HUB_ANIMAL_1	在「動物小屋」選擇「放牧」，\n就可與收容的動物近距離接觸，\n有機會獲得掉落的食材等道具。
MID_TUT_HUB_ANIMAL_2	只要在開放式茶座的布告欄\n投資各國並學習飼養方法，\n就能收容更多種類的動物。
MID_TUT_HUB_AMIIBO_OPEN	「amiibo SPOT」開放了。
MID_TUT_HUB_AMIIBO_TITLE	amiibo SPOT
MID_TUT_HUB_AMIIBO_0	只要在「amiibo SPOT」讀取amiibo，\n就可獲得道具等各種特典。
MID_TUT_HUB_AMIIBO_1	若讀取FIRE EMBLEM的相關amiibo，\n就有機會獲得特殊特典。
MID_TUT_HUB_DRILLINGSHOP_OPEN	「鍛造店」和「裝飾品店」開張了。
MID_TUT_HUB_DRILLINGSHOP_TITLE	鍛造店
MID_TUT_HUB_DRILLINGSHOP_0	只要提供「鍛造店」材料跟金幣，\n就可請店家強化武器。
MID_TUT_HUB_DRILLINGSHOP_1	「鍛造・進化」可以提升武器的性能，\n或製作其他更強的武器。
MID_TUT_HUB_DRILLINGSHOP_2	透過「紋章刻印」便能賦予武器紋章士的能力。\n一名紋章士的能力只能刻印在一個喜歡的武器上，\n之後亦能將紋章改為刻印至其他武器上。
MID_TUT_HUB_DRILLINGSHOP_3	「交換材料」能將鍛造用的材料\n交換成其他種類的材料。
MID_TUT_HUB_ACCESSORYSHOP_TITLE	裝飾品店
MID_TUT_HUB_ACCESSORYSHOP_0	只要提供「裝飾品店」材料跟金幣，\n就可請店家製作能在索拉涅爾\n穿戴的「衣服」或「飾品」。
MID_TUT_HUB_ACCESSORYSHOP_1	除了部分特別的飾品，\n其餘店家製作的飾品\n皆可穿戴在每位角色身上。
MID_TUT_HUB_ACCESSORYSHOP_2	隨著故事劇情的發展，\n能請店家製作的東西也會增加。
MID_TUT_HUB_COOK_OPEN	可以在「開放式茶座」製作「料理」了。
MID_TUT_HUB_COOK_TITLE	製作料理
MID_TUT_HUB_COOK_0	可以請負責掌廚的人製作「料理」\n和夥伴一起享用。
MID_TUT_HUB_COOK_1	若做出美味的料理，\n下次出擊期間就會強化我方全員的能力值。
MID_TUT_HUB_COOK_2	此外，一起用餐的夥伴\n也會提升支援值。
MID_TUT_HUB_COOK_3	且用餐後還有機會獲得道具「便當」。\n（在出擊期間使用可回復HP）
MID_TUT_HUB_CAPERIDGE_OPEN	「試煉別屋」開放了。
MID_TUT_HUB_CAPERIDGE_TITLE	試煉別屋
MID_TUT_HUB_CAPERIDGE_0	在「試煉別屋」可以挑戰各式各樣的「試煉」，\n贏得勝利將能獲得獎勵。
MID_TUT_HUB_CAPERIDGE_1	「連戰的試煉」\n須連續過關地圖，\n玩家可在挑戰時選擇難度。
MID_TUT_HUB_CAPERIDGE_2	「續戰的試煉」是利用網路和其他玩家合作，\n用接力的方式遊玩1個地圖關卡，奪得勝利。
MID_TUT_HUB_CAPERIDGE_3	「異界的試煉」是使用自己編輯的地圖\n和其他玩家的部隊在網路上對戰。
MID_TUT_HUB_FISHING_OPEN	可以「釣魚」了！
MID_TUT_HUB_FISHING_TITLE	釣魚
MID_TUT_HUB_FISHING_0	可以享受「釣魚」的活動。\n用\x0E\x08\x02\x04\x02A鍵在喜歡的位置垂下釣竿吧。\n（大波紋下面可能會有大魚）
MID_TUT_HUB_FISHING_1	在浮標完全沉下去的瞬間\n按\x0E\x08\x02\x04\x02A鍵魚就會上鉤。
MID_TUT_HUB_FISHING_2	魚掙扎時就往反方向推動\x0E\x08\x02\x0E\x0CStickL吧！\n如果沒辦法順利收線，魚就會逃跑。
MID_TUT_HUB_FISHING_3	收線將魚拉到身前時，就是大好機會。\n這時要連按\x0E\x08\x02\x04\x02A鍵削減魚的體力。
MID_TUT_HUB_FISHING_4	將魚的體力減至0，就能成功釣起！\n若獲得新的釣竿，搞不好能釣到更大的魚！
MID_TUT_HUB_DRAGONRIDE_OPEN	可以遊玩「飛龍射手」了！
MID_TUT_HUB_DRAGONRIDE_TITLE	飛龍射手
MID_TUT_HUB_DRAGONRIDE_0	「飛龍射手」是要乘著飛龍，\n破壞空中標靶取得高分的活動。
MID_TUT_HUB_DRAGONRIDE_1	破壞特別的標靶，取得最佳得分吧！\n（隨著故事劇情推進，會開放新的難度）
MID_TUT_HUB_FLEAMARKET_OPEN	「跳蚤市場」開張了。
MID_TUT_HUB_FLEAMARKET_TITLE	跳蚤市場
MID_TUT_HUB_FLEAMARKET_0	在「跳蚤市場」裡可以買到\n一般店家所沒有的珍貴商品。
MID_TUT_HUB_FLEAMARKET_1	商品種類會隨時變動，\n建議可以偶爾來看看。
MID_TUT_HUB_FORTUNE_OPEN	「占卜小屋」開張了。
MID_TUT_HUB_FORTUNE_TITLE	占卜小屋
MID_TUT_HUB_FORTUNE_0	「占卜小屋」裡的賽安達斯\n會用卡牌幫人占卜吉凶。
MID_TUT_HUB_FORTUNE_1	只有晚上會營業，\n想占卜就日落之後再來吧。
MID_TUT_HUB_PROFILE_OPEN	可以使用「活動記錄館」了
MID_TUT_HUB_CAPERIDGE_DETAIL_TITLE	試煉中的出擊
MID_TUT_HUB_CAPERIDGE_DETAIL_0	我方在各種「試煉」出擊期間產生的\n「狀態變化」、「消費的道具」及「倒下的夥伴」\n都會在遊玩結束後恢復原狀。
MID_TUT_HUB_CAPERIDGE_DETAIL_1	遊玩結束後可領取道具及經驗值獎勵。
MID_TUT_HUB_CAPERIDGE_DETAIL_2	為了過關獲取獎勵，\n大膽使用道具，盡情遊玩吧。
MID_TUT_CHALLENGE_TITLE	連戰的試煉
MID_TUT_CHALLENGE_0	「連戰的試煉」\n須連續挑戰地圖，\n以過關為目標。
MID_TUT_CHALLENGE_1	過關指定數目的地圖後，\n不僅可獲得材料獎勵，\n出擊的我方單位亦會獲得經驗值。
MID_TUT_CHALLENGE_2	選擇連戰地圖時可設定難度，\n難度越高，過關後獲得的獎勵越豐厚。
MID_TUT_RELAY_TITLE	續戰的試煉
MID_TUT_RELAY_0	「續戰的試煉」就像接力賽一樣，\n要與其他玩家在同一地圖內輪流\n遊玩一定的回合，以過關為目標。
MID_TUT_RELAY_1	選擇「開啟新的戰鬥」，\n就會消費票券展開「續戰的試煉」。
MID_TUT_RELAY_2	選擇「繼承」，\n則可繼承別人的資料遊玩。
MID_TUT_RELAY_3	選擇「查看結果」，\n就可觀看自己參與的戰鬥的重播記錄，\n若戰鬥已結束，則可領取獎勵。
MID_TUT_RELAY_ENTRY_PANEL_TITLE	入口面板
MID_TUT_RELAY_ENTRY_PANEL_0	「入口面板」及周圍4格\n皆可配置我方單位，\n最多可派5人出擊。
MID_TUT_RELAY_ENTRY_PANEL_1	地圖上有數個未啟動的入口面板，\n讓我方單位在面板上待命即可啟動。
MID_TUT_RELAY_ENTRY_PANEL_2	一旦啟動面板，繼承資料的玩家\n即可讓我方單位從該處出擊，\n建議盡可能啟動所有面板。
MID_TUT_RELAY_DATA_TAKEOVER_TITLE	繼承資料
MID_TUT_RELAY_DATA_TAKEOVER_0	遊玩至一定回合數後，\n便可設定讓其他玩家繼承的方式。
MID_TUT_RELAY_DATA_TAKEOVER_1	繼承方式如下，\n「公開」：任何人都可繼承。\n「非公開」：需先取得ID，並輸入該ID繼承。
MID_TUT_RELAY_DATA_TAKEOVER_2	可從「查看結果」中查看之後的\n戰鬥情況及勝負結果。
MID_TUT_RELAY_NEWDATA_TITLE	開啟新的戰鬥
MID_TUT_RELAY_NEWDATA_0	建立新的資料，\n並從頭開始試煉。
MID_TUT_RELAY_NEWDATA_1	請查看「地圖資訊」\n並選擇欲遊玩的地圖。
MID_TUT_RELAY_NEWDATA_2	選擇地圖後將進入出擊準備，\n此時選擇「開始戰鬥」\n就會消費票券展開試煉。
MID_TUT_RELAY_TAKEOVER_TITLE	繼承
MID_TUT_RELAY_TAKEOVER_0	繼承其他玩家的資料，\n並從地圖的中途展開試煉。\n繼承方式分別為「隨機」及「輸入ID」。
MID_TUT_RELAY_TAKEOVER_1	若選擇「隨機」，\n將會自動選擇其他玩家的資料，\n並在繼承後開始遊玩。
MID_TUT_RELAY_TAKEOVER_2	若選擇「輸入ID」，\n則可繼承指定玩家的資料，\n並開始遊玩。
MID_TUT_RELAY_TAKEOVER_3	選擇「開始戰鬥」即可展開試煉。
MID_TUT_RELAY_FINISH_TITLE	查看結果
MID_TUT_RELAY_FINISH_0	可從自己參與的「續戰的試煉」的資料中\n查看遊玩狀況。\n若試煉已結束，則可領取獎勵。
MID_TUT_RELAY_FINISH_1	亦可查看自己\n與其他玩家的重播記錄。\n（戰鬥結束前只會播到當前進度）
MID_TUT_RELAY_FINISH_2	即使敗北，亦可獲得獎勵，\n但勝利將會獲得更豐厚的獎勵。
MID_TUT_MATCH_TITLE	異界的試煉
MID_TUT_MATCH_0	可使用自己編輯或選擇的地圖\n與其他玩家的部隊展開對戰的試煉。
MID_TUT_MATCH_1	「輕鬆對戰」可選擇自己喜歡的地圖展開對戰。
MID_TUT_MATCH_2	「正式對戰」可公開自己編輯的地圖\n或將自己的地圖與其他玩家\n公開的地圖拼在一起對戰。
MID_TUT_MATCH_3	無論選擇哪種對戰，\n都可在對戰後獲得獎勵。
MID_TUT_MATCH_EASY_TITLE	輕鬆對戰
MID_TUT_MATCH_EASY_0	選擇喜歡的地圖，讓攻擊部隊出擊，\n與其他玩家的部隊展開對戰。\n可從「隨機」「朋友」「輸入ID」中選擇對手。
MID_TUT_MATCH_EASY_1	「隨機」：\n將自動選擇對戰的部隊。
MID_TUT_MATCH_EASY_2	「朋友」：\n將顯示朋友的部隊，\n可從中選擇對戰部隊。
MID_TUT_MATCH_EASY_3	「輸入ID」：\n輸入ID後，\n可與指定玩家的部隊展開對戰。
MID_TUT_MATCH_SERIOUS_TITLE	正式對戰
MID_TUT_MATCH_SERIOUS_0	可公開自己編輯的地圖，\n也可把自己的地圖與其他玩家\n公開的地圖拼在一起對戰。
MID_TUT_MATCH_SERIOUS_1	首先在「編輯地圖」中\n製作自己的地圖吧。
MID_TUT_MATCH_EDIT_ATTACK_TITLE	用自己編輯的地圖對戰
MID_TUT_MATCH_EDIT_ATTACK_0	編輯好地圖後，\n即可使用該地圖展開對戰。
MID_TUT_MATCH_EDIT_ATTACK_1	若選擇「開始對戰」，自己編輯的地圖\n將與其他玩家公開的地圖拼在一起，\n派遣攻擊部隊前往該地圖，就會開始對戰。
MID_TUT_MATCH_EDIT_ATTACK_2	若展開了防衛戰，\n則可從「查看結果」中\n查看該場戰事的結果及觀看重播記錄。
MID_TUT_MATCH_EDIT_ATTACK_3	若選擇「模擬戰」，\n則可測試自己編輯的地圖，\n藉此確認地圖的實際情況。
MID_TUT_MATCH_ATTACK_TITLE	開始對戰
MID_TUT_MATCH_ATTACK_0	可將自己的地圖與其他玩家公開的地圖拼在一起，\n並派出攻擊部隊開始對戰。
MID_TUT_MATCH_ATTACK_1	「隨機」：\n自動選擇其他玩家的地圖，\n並展開對戰。
MID_TUT_MATCH_ATTACK_2	「朋友」：\n將顯示朋友的地圖，\n可從中選擇對戰地點。
MID_TUT_MATCH_ATTACK_3	「輸入ID」：\n輸入ID後，\n可在指定玩家的地圖展開對戰。
MID_TUT_MATCH_EDIT_TITLE	編輯地圖
MID_TUT_MATCH_EDIT_0	可製作對戰用的地圖。\n擬定作戰方式，\n在地圖上配置各種地形吧。
MID_TUT_MATCH_EDIT_1	可用\x0E\x08\x02\x04\x02X鍵開啟地形清單，\n再用\x0E\x08\x02\x04\x02A鍵配置地形。\n（也可用\x0E\x08\x02\x04\x02L鍵、\x0E\x08\x02\x04\x02R鍵直接選擇地形）
MID_TUT_MATCH_EDIT_2	儲存製作好的地圖後，\n可能會有敵軍進攻，出現「防衛戰」。\n製作地圖時也將防衛時的情況納入考量吧。
MID_TUT_MATCH_EDIT_3	可用\x0E\x08\x02\x0A\x08Plus鍵打開選單，\n設定防衛戰用的「防衛部隊」\n或儲存製作好的地圖。
MID_TUT_MATCH_EDIT_SAVE_TITLE	設定防衛部隊及儲存地圖
MID_TUT_MATCH_EDIT_SAVE_0	「防衛部隊」會在出現防衛戰時自動戰鬥，\n可透過選單替該部隊編組單位、更改裝備及配置。
MID_TUT_MATCH_EDIT_SAVE_1	把游標對準我方單位後按下\x0E\x08\x02\x04\x02A鍵，\n還可更改行動類型。
MID_TUT_MATCH_EDIT_SAVE_2	設定為「防衛部隊」的單位\n將無法加入「攻擊部隊」，\n還請多加留意。
MID_TUT_MATCH_EDIT_SAVE_3	配置完地形及防衛部隊後，\n就選擇「儲存地圖」，\n儲存製作好的地圖吧。
MID_TUT_MATCH_EDIT_SAVE_4	選擇「結束編輯」，\n即可結束地圖的編輯。
MID_TUT_MATCH_REPLAY_TITLE	查看結果（重播記錄）
MID_TUT_MATCH_REPLAY_0	公開自己編輯的地圖後，\n其他玩家有可能會向該地圖進攻，\n此時就會出現「防衛戰」。
MID_TUT_MATCH_REPLAY_1	若出現「防衛戰」，\n可在此查看勝負結果。
MID_TUT_MATCH_REPLAY_2	亦可觀看重播記錄，\n查看當時的戰況。
MID_TUT_MATCH_REPLAY_3	即使敗北，亦可獲得獎勵，\n但勝利將會獲得更豐厚的獎勵。
MID_TUT_MATCH_MOCKCOMBAT_TITLE	模擬戰
MID_TUT_MATCH_MOCKCOMBAT_0	可測試自己編輯的地圖\n並確認地圖的實際情況。
MID_TUT_MATCH_MOCKCOMBAT_1	此時會派遣攻擊部隊前往自己的地圖，\n與防衛部隊展開對戰。
MID_TUT_MATCH_MOCKCOMBAT_2	若找到可改善之處，\n就到「編輯地圖」調整地圖吧。
MID_TUT_TIPS_Marth	紋章士馬爾斯
MID_TUT_TIPS_Siglud	紋章士西格爾特
MID_TUT_TIPS_Celica	紋章士賽莉卡
MID_TUT_TIPS_Micaiah	紋章士米卡雅
MID_TUT_TIPS_Roy	紋章士羅伊
MID_TUT_TIPS_Lin	紋章士琳
MID_TUT_TIPS_Ike	紋章士艾克
MID_TUT_TIPS_Lucina	紋章士露琪娜
MID_TUT_TIPS_Leaf	紋章士里弗
MID_TUT_TIPS_Kamui	紋章士神威
MID_TUT_TIPS_Eirik	紋章士艾莉可
MID_TUT_TIPS_Ephraim	紋章士艾夫拉姆
MID_TUT_TIPS_Byleth	紋章士貝雷特
MID_TUT_TIPS_TUTORIAL	基礎知識
MID_TUT_TIPS_ITEM	消費道具
MID_TUT_TIPS_WEAPON	武器
MID_TUT_TIPS_KIZUNA	散步
MID_TUT_TIPS_HUB	索拉涅爾
MID_TUT_TIPS_GMAP	世界地圖
MID_TUT_TIPS_ENCOUNTER	遭遇戰
MID_TUT_TIPS_UNIT_SKILL	（\x0E\x01\x00\x00的個人特技）
MID_TUT_TIPS_GOD_SKILL	（\x0E\x01\x00\x00的紋章士特技）
MID_TUT_TIPS_UNIT_ITEM	（\x0E\x01\x00\x00的專用武器）
MID_TUT_TIPS_GOD_ITEM	（\x0E\x01\x00\x00的結合武器）
MID_TIPS_TUTORIAL_1	曾經看過的指南可在「系統」中的「指南」隨時查看。
MID_TIPS_TUTORIAL_2	可在「系統」中的「環境設定」開啟或關閉戰鬥動畫。
MID_TIPS_TUTORIAL_3	在戰鬥地圖上按\x0E\x08\x02\x06\x04ZL鍵可顯示所有敵人的攻擊範圍。
MID_TIPS_TUTORIAL_4	把游標瞄準敵人後按下\x0E\x08\x02\x04\x02A鍵就會顯示危險範圍。
MID_TIPS_TUTORIAL_5	即使還有尚未行動的我方單位，只要從選單選擇「結束」就可以結束我軍的行動階段。
MID_TIPS_TUTORIAL_6	在對話時按住\x0E\x08\x02\x04\x02Y鍵即可快轉。
MID_TIPS_TUTORIAL_7	經驗值到達100就會提升等級，也會提高我方單位的能力。
MID_TIPS_TUTORIAL_8	按下\x0E\x08\x02\x04\x02X鍵就能看見道具或特技的詳細資訊。
MID_TIPS_TUTORIAL_9	將游標對準單位後按下\x0E\x08\x02\x0C\nMinus鍵就能查看詳細的能力。
MID_TIPS_TUTORIAL_10	在戰鬥地圖長按\x0E\x08\x02\x06\x04ZR鍵就可切換單位資訊的種類或地圖顯示。
MID_TIPS_TUTORIAL_50	在戰鬥地圖按下\x0E\x08\x02\x06\x04ZR鍵即可顯示單位的輔助資訊。
MID_TIPS_TUTORIAL_11	武器的「重量」大於「體格」的話，「速度」就會下降。
MID_TIPS_TUTORIAL_12	「幸運」越高，越不容易受到敵人的必殺攻擊。
MID_TIPS_TUTORIAL_13	只要在「草叢」或「林地」等地形中戰鬥，就不容易遭受敵人攻擊。
MID_TIPS_ITEM_0	HP可透過「傷藥」或「聖療」回復。
MID_TIPS_ITEM_1	「傷藥」和「杖」等道具當使用次數歸零就會消失。
MID_TIPS_TUTORIAL_14	選擇「委任」的話，我方單位就會配合戰鬥方針自主行動。
MID_TIPS_TUTORIAL_15	只要以「槍」攻擊拿劍的敵人、「斧」攻擊拿槍的敵人、「劍」攻擊拿斧的敵人就能讓對手陷入打破狀態。
MID_TIPS_TUTORIAL_51	以「體術」攻擊裝備弓、魔道書、短劍的敵人，就可使其陷入打破狀態。
MID_TIPS_TUTORIAL_16	陷入打破狀態的對手除非經過一次戰鬥或輪到下個回合，否則無法反擊。
MID_TIPS_TUTORIAL_17	連鎖防禦無法抵擋「結合技」。
MID_TIPS_SKILL_0	「牽絆等級」提升後，可提升同步或結合時的能力，增加可使用的特技。\n
MID_TIPS_SKILL_1	「結合計量條」會透過戰鬥累積。
MID_TIPS_SKILL_28	只要在「紋章氣格子」內待命，結合計量條就會累積至上限。
MID_TIPS_SKILL_2	馬爾斯的結合技「星之突擊」在與戰鬥類型為【龍族】的夥伴結合時，會增加攻擊次數。
MID_TIPS_ITEM_2	裝備體術時的攻擊力會受到「力量」和「魔力」這兩項基本能力影響。
MID_TIPS_TUTORIAL_18	我方單位皆有能派上用場的獨門的特技，詳細內容可按\x0E\x08\x02\x04\x02X鍵查看。
MID_TIPS_TUTORIAL_19	只要看「部隊表」就能一覽我方單位的兵種或等級。
MID_TIPS_TUTORIAL_20	我方單位相鄰戰鬥就會提升彼此的支援值。
MID_TIPS_TUTORIAL_21	在選擇我方單位時按下\x0E\x08\x02\x04\x02L\x0E\x08\x02\x04\x02R鍵就可替換裝備的武器。
MID_TIPS_TUTORIAL_22	打倒帶有\x0E\x08\x02\x12\x10DropItem圖示的敵人就可獲得該敵人持有的道具。
MID_TIPS_ITEM_3	弓有「克制飛行」的效果，會對飛行的敵人造成大量傷害。
MID_TIPS_ITEM_4	重裝兵的「防守」很高，魔法攻擊較容易對其造成傷害。
MID_TIPS_OTHER_33	可在「我的床」的「更改難度」中更改遊戲的難度。
MID_TIPS_TUTORIAL_24	在敵人到達前「訪問」民宅就能獲得獎勵。
MID_TIPS_TUTORIAL_25	在「堡壘」或「防衛地板」上待命的單位每回合都會回復HP，且不會因為武器屬性陷入打破狀態。
MID_TIPS_TUTORIAL_27	\x0E\x06\x03\x00及與其相鄰的我方單位可以使用「運輸隊」。
MID_TIPS_TUTORIAL_28	提升牽絆等級就會觸發「牽絆對話」，觀看後會進一步提升牽絆等級。
MID_TIPS_TUTORIAL_29	我方單位的支援值上升就會觸發「支援對話」，觀看支援對話後會提升「支援等級」。
MID_TIPS_TUTORIAL_30	若我方單位的「支援等級」提升，在該單位附近戰鬥時就會提高能力。
MID_TIPS_TUTORIAL_32	可讓敵人陷入打破狀態時，敵人的武器圖示上會顯示\x0E\x08\x02\x18\x16EquipCancel的記號。
MID_TIPS_TUTORIAL_33	當單位顯示\x0E\x08\x02 \x1EBalloonCritical圖示時，較容易使出必殺攻擊。
MID_TIPS_TUTORIAL_34	使用「龍之時水晶」就可回到行動前的時間點重新開始。
MID_TIPS_ITEM_5	除了弓和魔法之外，「標槍」和「手斧」這些武器也能攻擊遠方敵人。
MID_TIPS_ITEM_6	魔道書「浪湧」雖然只能攻擊相鄰的敵人，但必定會命中敵人。
MID_TIPS_OTHER_0	和戰鬥中表現亮眼的夥伴對話就可獲得「牽絆碎片」。
MID_TIPS_OTHER_1	獲得的晶石和食材可以用在「鍛造」或「料理」上。
MID_TIPS_OTHER_2	在「紋章士之間」可使用「牽絆碎片」精煉牽絆戒指。
MID_TIPS_OTHER_3	按下\x0E\x08\x02\x04\x02X鍵就可立即使用快捷旅行移動至想去的地方。
MID_TIPS_OTHER_4	「贈送禮物」時，若選擇對方喜歡的東西將可提升更多支援值。
MID_TIPS_OTHER_6	使用「音箱」就可以隨意更改背景音樂。
MID_TIPS_OTHER_7	在「我的房間」不僅可觀看支援對話，還可鑑賞影片和音樂。
MID_TIPS_OTHER_8	在「我的床」上休息時，有時會有夥伴來叫玩家起床。
MID_TIPS_OTHER_9	在「紋章士之間」可使用「SP」或「牽絆碎片」來「特技繼承」或「精煉牽絆戒指」。
MID_TIPS_OTHER_10	傳說自古便棲息在索拉涅爾的守護神會從尾巴生出「牽絆碎片」。
MID_TIPS_OTHER_11	在「飛龍射手」中拿下高分將可獲得許多「牽絆碎片」。
MID_TIPS_OTHER_12	做「肌肉體操」的話，下次出擊期間會稍微強化\x0E\x06\x03\x00的能力。
MID_TIPS_OTHER_32	可用\x0E\x08\x02\x06\x04ZR鍵選擇多個道具，一次販售。
MID_TIPS_TUTORIAL_35	即使敵人奪走寶箱裡的道具，只要在敵人逃跑前將其擊敗就能奪回。
MID_TIPS_TUTORIAL_36	遇到門扉地形時，只要將其破壞或使用小偷的指令「門扉鑰匙」就能通過。
MID_TIPS_ITEM_8	「HP藥」等強化道具會在出擊期間內提升我方單位的能力。
MID_TIPS_ITEM_9	「騎士殺手」等有「克制騎馬」效果的武器可對騎馬類敵人造成大量傷害。
MID_TIPS_OTHER_13	在「牧場」放養帶回索拉涅爾的動物，有時會掉落食材。
MID_TIPS_OTHER_15	世界地圖會出現「遭遇戰」或「訓練」，可獲得經驗值和金幣。
MID_TIPS_OTHER_16	在「鍛鍊之間」可以和夥伴及紋章士戰鬥來獲得經驗值和加深牽絆。
MID_TIPS_OTHER_17	參與「訓練」的我方單位在過關後能獲得更多經驗值。
MID_TIPS_TUTORIAL_39	戰鬥類型為【龍族】的單位在結合時可獲得各種附加效果。
MID_TIPS_TUTORIAL_40	戰鬥類型為【連攜】的單位能使用支援我方單位戰鬥的「連鎖攻擊」。
MID_TIPS_TUTORIAL_41	戰鬥類型為【騎馬】的單位可移動的距離較遠。
MID_TIPS_TUTORIAL_42	戰鬥類型為【魔道】的單位以魔法攻擊時，會使敵人因地形效果獲得的回避+補正無效。
MID_TIPS_TUTORIAL_43	戰鬥類型為【氣功】的單位能使用保護我方單位的「連鎖防禦」。
MID_TIPS_TUTORIAL_44	戰鬥類型為【隱密】的單位會使因地形效果獲得的回避+補正變成2倍。
MID_TIPS_TUTORIAL_45	戰鬥類型為【飛行】的單位移動時不會受地形效果影響。
MID_TIPS_TUTORIAL_46	戰鬥類型【重裝】的單位不會因為武器屬性陷入打破狀態。
MID_TIPS_TUTORIAL_47	可透過提升「牽絆等級」從紋章士身上繼承轉職的必要資質。
MID_TIPS_ITEM_10	以長射程的武器攻擊裝備近身武器的敵人就不會遭到反擊。
MID_TIPS_ITEM_11	用短劍對敵人造成傷害就可讓敵人陷入「中毒」狀態。
MID_TIPS_ITEM_12	「破甲劍」等有「克制重裝」效果的武器可對重裝兵造成大量傷害。
MID_TIPS_OTHER_14	製作「料理」偶爾可以得到便當，使用後可回復HP。
MID_TIPS_OTHER_19	請人「製作料理」時添加其他食材，就能提升料理的成功率。
MID_TIPS_OTHER_20	在「果樹園」可獲得料理用的食材。
MID_TIPS_OTHER_21	依據目前為止的行動可在「布告欄」的「成就」獲得不等的「牽絆碎片」。
MID_TIPS_OTHER_22	在「布告欄」的「投資國家」中投資高額資金就能提升等級，獲得謝禮。
MID_TIPS_OTHER_30	利用「投資國家」提升投資等級後，該國家的遭遇戰中出現稀有敵人的機率也會上升。
MID_TIPS_OTHER_31	利用「投資國家」提升投資等級後，在該國家散步時所能獲得的材料也會增加。
MID_TIPS_OTHER_23	出現「黑暗」的遭遇戰裡很可能潛伏著持有大量經驗值和金幣的敵人。
MID_TIPS_SKILL_38	杖的命中僅可依據特技「信仰」提升。
MID_TIPS_OTHER_34	在試煉別屋與異界的朋友交流時，「神龍戰歷卡」將可派上用場。
MID_TIPS_TUTORIAL_48	闇之同步的敵人可在結合計量條閃爍時使用結合技。
MID_TIPS_TUTORIAL_52	我方單位結合時若受到敵方的結合技攻擊，將會減輕傷害。
MID_TIPS_TUTORIAL_49	即使等級已達上限，也能使用「轉職證」將等級恢復成1，使能力繼續成長。
MID_TIPS_ITEM_13	「中毒」的效果會在出擊期間內持續生效。（用解毒劑或杖即可治療）
MID_TIPS_ITEM_14	我方單位等級提升至10後，便可使用「大師證」轉職成高級兵種。
MID_TIPS_ITEM_15	使用持有「猛擊」效果的武器發動攻擊必定為後攻。
MID_TIPS_OTHER_24	在「湧泉池畔」釣到的魚可以當成料理的食材。
MID_TIPS_ITEM_16	使用「轉職證」就可轉職成其他類型的兵種。
MID_TIPS_ITEM_17	「必殺劍」、「必殺槍」等必殺型武器較容易使出必殺攻擊。
MID_TIPS_OTHER_37	\x0E\x06\x03\x00的兵種變成「神龍之王」後，即可在後院遊玩「飛龍射手」。
MID_TIPS_OTHER_26	在「跳蚤市場」可以買到一般店家所沒有的珍貴商品。
MID_TIPS_OTHER_27	這片大陸的各處似乎有試煉之地，能加深與紋章士之間的牽絆。
MID_TIPS_SKILL_29	艾克的結合技「霸克・天空」可消除範圍攻擊內格子的「火焰」及「瘴氣」。
MID_TIPS_SKILL_22	與貝雷特結合的我方單位，其戰鬥類型會影響貝雷特的結合武器。
MID_TIPS_SKILL_25	神威的「龍脈」會賦予地形特殊效果，並取代原本的效果。
MID_TIPS_OTHER_28	「占卜小屋」只有晚上會營業。
MID_TIPS_OTHER_29	在「試煉別屋」挑戰試煉就可獲得特別的強化材料，強化結合武器。
MID_TIPS_ITEM_18	「勇者之劍」、「勇者之槍」等勇者型武器，若由自身發動攻擊，將連續攻擊2次。
MID_TIPS_ITEM_19	若想將「約定戒指」交給重要的人，就從我的房間中的櫃子取出戒指，直接交給對方吧。
MID_TIPS_GOD_0	異界阿卡奈亞陸地中阿利提亞王國的王子，繼承了英雄昂利的血脈。
MID_TIPS_GOD_1	和夥伴合力打倒暗黑龍，是眾人口中的「英雄王」。
MID_TIPS_GOD_2	異界尤格多拉爾陸地中格蘭貝魯王國的希亞費公爵家勳爵。
MID_TIPS_GOD_3	流有聖戰士巴爾德的血脈，是繼承傳說聖劍的高潔騎士。
MID_TIPS_GOD_4	異界瓦倫西亞陸地中豐饒之國索菲亞的公主。
MID_TIPS_GOD_5	是名慈悲為懷的女子，和勇者阿雷武一起對抗危害和平的邪神。
MID_TIPS_GOD_6	在異界堤里烏斯陸地以義賊團成員身分大顯身手的女子。
MID_TIPS_GOD_7	是名擁有神秘力量的少女，對抗了欲制裁世界的女神。
MID_TIPS_GOD_8	異界埃列布陸地的費雷侯爵家勳爵，封印之劍的主人。
MID_TIPS_GOD_9	代替臥病在床的父親，率兵對抗敵國的聰明少年。
MID_TIPS_GOD_10	來自異界埃列布陸地的草原地帶──塞迦地區的女劍士。
MID_TIPS_GOD_11	不知身上流有侯爵家的血脈，被當成遊牧民族養大的少女。
MID_TIPS_GOD_12	曾在異界堤里烏斯陸地擔任格萊爾傭兵團團長的青年。
MID_TIPS_GOD_13	擁有精湛劍術和真誠的心，從一介傭兵變成了英雄。
MID_TIPS_GOD_14	異界伊里斯聖王國的公主，左眼上有聖痕。
MID_TIPS_GOD_15	充滿正義感的少女，為了改變絕望的未來而穿越時空戰鬥。
MID_TIPS_GOD_16	異界尤格多拉爾陸地中色雷斯地區倫斯特王國的繼承人。
MID_TIPS_GOD_17	為了讓色雷斯地區擺脫帝國統治而奮戰到底的勇敢王子。
MID_TIPS_GOD_18	異界的王族，生於白夜王國，長於暗夜王國。
MID_TIPS_GOD_19	擁有神祖龍的力量，在互相爭戰的兩個祖國間選擇了自己的道路。
MID_TIPS_GOD_20	異界麥格維爾陸地中繼承聖石的路奈斯王國公主。
MID_TIPS_GOD_21	英勇的路奈斯王國王子，和妹妹艾莉可一起對抗魔王。
MID_TIPS_GOD_22	在異界芙朵拉的加爾古・瑪庫大修道院中擔任教師的青年。
MID_TIPS_GOD_23	由傭兵轉行為教師，引領著學生挺過了戰亂時代。
MID_TUT_NAVI_M004_TIMECRYSTAL	可以使用「龍之時水晶」了！
MID_TUT_NAVI_M005_FUNDS	費列聶王國提供了\n軍費\x0E\x01\x00\x00\x0E\x01\x01\x00G。
MID_TUT_NAVI_VANDRE_FUNDS	凡德雷提供了\n軍費\x0E\x01\x00\x00\x0E\x01\x01\x00G。
MID_TUT_NAVI_M008_FUNDS	布羅帝亞王國提供了\n軍費\x0E\x01\x00\x00\x0E\x01\x01\x00G。
MID_TUT_NAVI_M012_RESCUE	拯救被異形兵襲擊的人吧！
MID_TUT_NAVI_M014_FUNDS	索爾姆王國提供了\n軍費\x0E\x01\x00\x00\x0E\x01\x01\x00G。
MID_TUT_NAVI_M015_ESCAPE	保護賽安達斯，讓他自地圖平安撤離吧！
MID_TUT_NAVI_M020_FUNDS	伊爾席翁王國提供了\n軍費\x0E\x01\x00\x00\x0E\x01\x01\x00G。
MID_TUT_NAVI_M022_GET_Siglud	獲得「聖戰騎士戒指」了。
MID_TUT_NAVI_M022_GET_Celica	獲得「慈悲公主戒指」了。
MID_TUT_NAVI_M022_GET_Micaiah	獲得「拂曉巫女戒指」了。
MID_TUT_NAVI_M022_GET_Roy	獲得「幼獅戒指」了。
MID_TUT_NAVI_M022_GET_Lin	獲得「草原女爵戒指」了。
MID_TUT_NAVI_M022_GET_Ike	獲得「蒼炎勇者戒指」了。
MID_TUT_NAVI_M022_GET_Lucina	獲得「聖公主戒指」了。
MID_TUT_NAVI_M022_GET_Leaf	獲得「賢王戒指」了。
MID_TUT_NAVI_M022_GET_Kamui	獲得「選擇未來之人戒指」了。
MID_TUT_NAVI_M022_GET_Eirik	獲得「碧綠風空戒指」了。
MID_TUT_NAVI_M022_GET_Byleth	獲得「引領者戒指」了。
MID_TUT_NAVI_M024_WARNING1	2回合後下方的山路會發生雪崩。
MID_TUT_NAVI_M024_WARNING2	2回合後中間的山路會發生雪崩。
MID_TUT_NAVI_M024_WARNING3	2回合後上方的山路會發生雪崩。
MID_TUT_NAVI_M026_ENGAGEBREAKE	下個回合會出現大邪龍尚卜爾的全體攻擊，\n將強制解除地圖上各單位的結合狀態。
MID_TUT_NAVI_M026_BEAM_WARNING	大邪龍尚卜爾會在下個回合施放邪龍吼叫炮。\n此特技相當強大，盡量退到攻擊範圍外吧。
MID_TUT_NAVI_S006_RULE	貝雷特的部隊會破壞地圖上的水晶。\n阻止他們，盡可能保護好水晶吧！\n（戰鬥結束後會依據剩下的水晶數量給予獎勵）
MID_TUT_NAVI_S006_BREAK	水晶已被破壞。
MID_TUT_NAVI_S006_REWARD1	成功守住了大量水晶，\n從貝雷特手中獲得了\x0E\x01\x00\x00和\x0E\x01\x01\x00作為獎勵。
MID_TUT_NAVI_S006_REWARD2	成功守住了不少水晶，\n從貝雷特手中獲得了\x0E\x01\x00\x00作為獎勵。
MID_TUT_NAVI_S006_REWARD3	守住的水晶不多，\n未能獲得獎勵。
MID_TUT_NAVI_S015_GET	取回戒指了。
MID_TUT_NAVI_S015_ENGAGERING	「約定戒指」只能交給一位夥伴，\n要送給誰可要想清楚喔。
